aérage|Ncfs|aérage
aérage|Ncms|aérage
aérosondage|Ncms|aérosondage
abêtissement|Ncms|abêtissement
abéchement|Ncms|abéchement
ébahissement|Ncms|ébahissement
abaissement|Ncms|abaissement
abandonnement|Ncms|abandonnement
ébarbage|Ncms|ébarbage
ébarbement|Ncms|ébarbement
ébarouissage|Ncms|ébarouissage
abasourdissement|Ncms|abasourdissement
abatardissement|Ncms|abatardissement
abâtardissement|Ncms|abâtardissement
abatellement|Ncms|abatellement
abattage|Ncms|abattage
abattement|Ncms|abattement
ébattement|Ncms|ébattement
ébaubissement|Ncms|ébaubissement
ébauchage|Ncms|ébauchage
ébaudissement|Ncms|ébaudissement
ébavurage|Ncms|ébavurage
abeillage|Ncms|abeillage
abergeage|Ncms|abergeage
ébergement|Ncms|ébergement
ébisèlement|Ncms|ébisèlement
éblouissement|Ncms|éblouissement
aboûment|Ncms|aboûment
aboîment|Ncms|aboîment
aboiement|Ncms|aboiement
aboivrement|Ncms|aboivrement
abolissement|Ncms|abolissement
abondement|Ncms|abondement
abonnement|Ncms|abonnement
abordage|Ncms|abordage
éborgnage|Ncms|éborgnage
éborgnement|Ncms|éborgnement
abornement|Ncms|abornement
ébouage|Ncms|ébouage
abouchement|Ncms|abouchement
ébouillantage|Ncms|ébouillantage
éboulage|Ncms|éboulage
éboulement|Ncms|éboulement
abouquement|Ncms|abouquement
ébourgeonnage|Ncms|ébourgeonnage
ébourgeonnement|Ncms|ébourgeonnement
ébouriffement|Ncms|ébouriffement
aboutage|Ncms|aboutage
éboutage|Ncms|éboutage
aboutement|Ncms|aboutement
aboutissement|Ncms|aboutissement
ébrèchement|Ncms|ébrèchement
abrégement|Ncms|abrégement
abrègement|Ncms|abrègement
ébranchage|Ncms|ébranchage
ébranchement|Ncms|ébranchement
ébranlement|Ncms|ébranlement
ébrasement|Ncms|ébrasement
abreuvage|Ncms|abreuvage
abreuvement|Ncms|abreuvement
abricotage|Ncms|abricotage
abrogement|Ncms|abrogement
ébrouage|Ncms|ébrouage
ébroudage|Ncms|ébroudage
ébrouement|Ncms|ébrouement
abroutissement|Ncms|abroutissement
ébruitement|Ncms|ébruitement
abrutissement|Ncms|abrutissement
écabochage|Ncms|écabochage
écachement|Ncms|écachement
écaillage|Ncms|écaillage
écaillement|Ncms|écaillement
écangage|Ncms|écangage
acérage|Ncms|acérage
écarquillement|Ncms|écarquillement
écartèlement|Ncms|écartèlement
écartement|Ncms|écartement
écôtage|Ncms|écôtage
écatissage|Ncms|écatissage
écœurement|Ncms|écœurement
accablement|Ncms|accablement
accaparement|Ncms|accaparement
accastillage|Ncms|accastillage
acclimatement|Ncms|acclimatement
accolage|Ncms|accolage
accolement|Ncms|accolement
accommodage|Ncms|accommodage
accommodement|Ncms|accommodement
accompagnage|Ncms|accompagnage
accompagnement|Ncms|accompagnement
accomplissement|Ncms|accomplissement
acconage|Ncms|acconage
accorage|Ncms|accorage
accordage|Ncms|accordage
accordement|Ncms|accordement
accostage|Ncms|accostage
accotement|Ncms|accotement
accouchement|Ncms|accouchement
accoudement|Ncms|accoudement
accouplage|Ncms|accouplage
accouplement|Ncms|accouplement
accoutrement|Ncms|accoutrement
accouvage|Ncms|accouvage
accrochage|Ncms|accrochage
accrochement|Ncms|accrochement
accroissement|Ncms|accroissement
accroupissement|Ncms|accroupissement
écervellement|Ncms|écervellement
échafaudage|Ncms|échafaudage
échaffaudage|Ncms|échaffaudage
achalandage|Ncms|achalandage
échalassage|Ncms|échalassage
échalassement|Ncms|échalassement
échantillonnage|Ncms|échantillonnage
échappement|Ncms|échappement
échardonnage|Ncms|échardonnage
écharnage|Ncms|écharnage
acharnement|Ncms|acharnement
écharnement|Ncms|écharnement
écharpement|Ncms|écharpement
échaudage|Ncms|échaudage
échaudement|Ncms|échaudement
échauffement|Ncms|échauffement
achèvement|Ncms|achèvement
échellement|Ncms|échellement
échelonnement|Ncms|échelonnement
achement|Ncms|achement
acheminement|Ncms|acheminement
échenillage|Ncms|échenillage
achevage|Ncms|achevage
échevelage|Ncms|échevelage
échevellement|Ncms|échevellement
échevettage|Ncms|échevettage
échevinage|Ncms|échevinage
échoguidage|Ncms|échoguidage
échoppage|Ncms|échoppage
achoppement|Ncms|achoppement
échosondage|Ncms|échosondage
échouage|Ncms|échouage
échouement|Ncms|échouement
aciérage|Ncms|aciérage
acidage|Ncms|acidage
écimage|Ncms|écimage
éclaboussage|Ncfs|éclaboussage
éclaboussement|Ncms|éclaboussement
éclairage|Ncms|éclairage
éclaircissage|Ncms|éclaircissage
éclaircissement|Ncms|éclaircissement
éclairement|Ncms|éclairement
éclatement|Ncms|éclatement
éclipsement|Ncms|éclipsement
éclissage|Ncms|éclissage
écloppement|Ncms|écloppement
éclusage|Ncms|éclusage
écoblanchiment|Ncms|écoblanchiment
écobuage|Ncms|écobuage
écochelage|Ncms|écochelage
écoemballage|Ncms|écoemballage
écolage|Ncms|écolage
écollage|Ncms|écollage
aconage|Ncms|aconage
acoquinement|Ncms|acoquinement
écorçage|Ncms|écorçage
écorage|Ncms|écorage
écorcement|Ncms|écorcement
écorchement|Ncms|écorchement
écornement|Ncms|écornement
écoulage|Ncms|écoulage
écoulement|Ncms|écoulement
écoussage|Ncms|écoussage
écouvillonnage|Ncms|écouvillonnage
écovillage|Ncms|écovillage
acquiescement|Ncms|acquiescement
acquittement|Ncms|acquittement
acréage|Ncms|acréage
écrêtage|Ncms|écrêtage
écrêtement|Ncms|écrêtement
écrabouillage|Ncms|écrabouillage
écrémage|Ncms|écrémage
écrénage|Ncms|écrénage
écrasage|Ncms|écrasage
écrasement|Ncms|écrasement
acridophage|Ncfs|acridophage
acridophage|Ncms|acridophage
écritement|Ncms|écritement
écroûtage|Ncms|écroûtage
écroûtement|Ncms|écroûtement
écrotage|Ncms|écrotage
écrouissage|Ncms|écrouissage
écrouissement|Ncms|écrouissement
écroulement|Ncms|écroulement
écroutage|Ncms|écroutage
écroutement|Ncms|écroutement
actionnement|Ncms|actionnement
écuissage|Ncms|écuissage
écumage|Ncms|écumage
écurage|Ncms|écurage
écurement|Ncms|écurement
écussonnage|Ncms|écussonnage
édéage|Ncms|édéage
adage|Ncms|adage
adéphage|Ncfs|adéphage
adéphage|Ncms|adéphage
adossement|Ncms|adossement
adoubement|Ncms|adoubement
adoucissage|Ncms|adoucissage
adoucissement|Ncms|adoucissement
adressage|Ncms|adressage
afféagement|Ncms|afféagement
afféage|Ncms|afféage
affaîtage|Ncms|affaîtage
affacturage|Ncms|affacturage
affadissement|Ncms|affadissement
affaiblissement|Ncms|affaiblissement
affairement|Ncms|affairement
affaisage|Ncms|affaisage
affaissement|Ncms|affaissement
affaitage|Ncms|affaitage
affaitement|Ncms|affaitement
affalement|Ncms|affalement
affûtage|Ncms|affûtage
affenage|Ncms|affenage
affermage|Ncms|affermage
affermissement|Ncms|affermissement
affichage|Ncms|affichage
affichement|Ncms|affichement
affilage|Ncms|affilage
affinage|Ncms|affinage
affinement|Ncms|affinement
affiquage|Ncms|affiquage
affleurage|Ncms|affleurage
affleurement|Ncms|affleurement
affleurissement|Ncms|affleurissement
affligement|Ncms|affligement
afflorinement|Ncms|afflorinement
afflouage|Ncms|afflouage
affolage|Ncms|affolage
affolement|Ncms|affolement
afforage|Ncms|afforage
afforestage|Ncms|afforestage
affouagement|Ncms|affouagement
affouage|Ncms|affouage
affouillement|Ncms|affouillement
affouragement|Ncms|affouragement
affourchement|Ncms|affourchement
affourragement|Ncms|affourragement
affrairement|Ncms|affrairement
affranchissage|Ncms|affranchissage
affranchissement|Ncms|affranchissement
affrèrement|Ncms|affrèrement
affrérissement|Ncms|affrérissement
affrètement|Ncms|affrètement
affrétement|Ncms|affrétement
affrontement|Ncms|affrontement
affublement|Ncms|affublement
affutage|Ncms|affutage
agacement|Ncms|agacement
égaiement|Ncms|égaiement
également|Ncms|également
égalisage|Ncms|égalisage
égarement|Ncms|égarement
agencement|Ncms|agencement
age|Ncms|age
agenouillement|Ncms|agenouillement
égermage|Ncms|égermage
agiotage|Ncms|agiotage
agissement|Ncms|agissement
églandage|Ncms|églandage
agnèlement|Ncms|agnèlement
agnelage|Ncms|agnelage
agnellement|Ncms|agnellement
égobelage|Ncms|égobelage
égorgement|Ncms|égorgement
égorgillement|Ncms|égorgillement
égouttage|Ncms|égouttage
agréage|Ncms|agréage
agrafage|Ncms|agrafage
égrainage|Ncms|égrainage
agrainage|Ncms|agrainage
agrément|Ncms|agrément
agrandissement|Ncms|agrandissement
égrénement|Ncms|égrénement
égrènement|Ncms|égrènement
égrappage|Ncms|égrappage
égrateronnage|Ncms|égrateronnage
égratteronnage|Ncms|égratteronnage
égrattonnage|Ncms|égrattonnage
égrenage|Ncms|égrenage
Agriophage|Ncfs|Agriophage
Agriophage|Ncms|Agriophage
égrisage|Ncms|égrisage
agroéquipement|Ncms|agroéquipement
agroenvironnement|Ncms|agroenvironnement
agroupement|Ncms|agroupement
égrugeage|Ncms|égrugeage
aguerrissement|Ncms|aguerrissement
égueulement|Ncms|égueulement
aguichage|Ncms|aguichage
ahanement|Ncms|ahanement
ahannement|Ncms|ahannement
aheurtement|Ncms|aheurtement
ahurissement|Ncms|ahurissement
aigage|Ncms|aigage
aigrissement|Ncms|aigrissement
aiguage|Ncms|aiguage
aiguillage|Ncms|aiguillage
aiguilletage|Ncms|aiguilletage
aiguillonnement|Ncms|aiguillonnement
aiguisage|Ncms|aiguisage
aiguisement|Ncms|aiguisement
œilletonnage|Ncms|œilletonnage
éjarrage|Ncms|éjarrage
éjectage|Ncms|éjectage
ajournement|Ncms|ajournement
ajoutage|Ncms|ajoutage
ajustage|Ncms|ajustage
ajustement|Ncms|ajustement
ajutage|Ncms|ajutage
élagage|Ncms|élagage
élégissement|Ncms|élégissement
alambiquage|Ncms|alambiquage
élément|Ncms|élément
élancement|Ncms|élancement
alanguissement|Ncms|alanguissement
élargissement|Ncms|élargissement
alésage|Ncms|alésage
élavage|Ncms|élavage
élèvement|Ncms|élèvement
alentissement|Ncms|alentissement
élevage|Ncms|élevage
alevinage|Ncms|alevinage
alicament|Ncms|alicament
alignement|Ncms|alignement
aliment|Ncms|aliment
élingage|Ncms|élingage
alitement|Ncms|alitement
allèchement|Ncms|allèchement
allégeage|Ncms|allégeage
allégement|Ncms|allégement
allègement|Ncms|allègement
allaitement|Ncms|allaitement
allélophage|Ncms|allélophage
alliage|Ncms|alliage
alliement|Ncms|alliement
allivrement|Ncms|allivrement
allongement|Ncms|allongement
allotement|Ncms|allotement
allotissement|Ncms|allotissement
allotriophage|Ncms|allotriophage
allumage|Ncms|allumage
alluvionnement|Ncms|alluvionnement
éloignement|Ncms|éloignement
îlotage|Ncms|îlotage
alourdissement|Ncms|alourdissement
aloyage|Ncms|aloyage
alpage|Ncms|alpage
aluminage|Ncms|aluminage
alunage|Ncms|alunage
alunissage|Ncms|alunissage
amadouement|Ncms|amadouement
amaigrissement|Ncms|amaigrissement
émaillage|Ncms|émaillage
améliorissement|Ncms|améliorissement
aménagement|Ncms|aménagement
aménage|Ncms|aménage
émandronage|Ncfs|émandronage
émargement|Ncms|émargement
amarinage|Ncms|amarinage
amarissage|Ncms|amarissage
amarrage|Ncms|amarrage
amarsissage|Ncms|amarsissage
amartissage|Ncms|amartissage
amasement|Ncms|amasement
amassage|Ncms|amassage
amassement|Ncms|amassement
ambage|Ncfs|ambage
amendement|Ncms|amendement
amenuisement|Ncms|amenuisement
émergement|Ncms|émergement
amerrissage|Ncms|amerrissage
émerveillement|Ncms|émerveillement
ameublement|Ncms|ameublement
ameublissement|Ncms|ameublissement
émeulage|Ncms|émeulage
ameutement|Ncms|ameutement
amidonnage|Ncms|amidonnage
émiettement|Ncms|émiettement
amincissement|Ncms|amincissement
amoindrissement|Ncms|amoindrissement
amollissement|Ncms|amollissement
émolument|Ncms|émolument
amoncèlement|Ncms|amoncèlement
amoncellement|Ncms|amoncellement
émondage|Ncms|émondage
émondement|Ncms|émondement
amorçage|Ncms|amorçage
amorcement|Ncms|amorcement
émorfilage|Ncms|émorfilage
amortissement|Ncms|amortissement
émottage|Ncms|émottage
émottement|Ncms|émottement
émouchement|Ncms|émouchement
émouchetage|Ncms|émouchetage
émoulage|Ncms|émoulage
émoussage|Ncms|émoussage
émoustillement|Ncms|émoustillement
émouvement|Ncms|émouvement
ampérage|Ncms|ampérage
amuïssement|Ncms|amuïssement
amunitionnement|Ncms|amunitionnement
amusement|Ncms|amusement
anéantissement|Ncms|anéantissement
énallage|Ncfs|énallage
ancrage|Ncms|ancrage
énervement|Ncms|énervement
anglaisage|Ncms|anglaisage
éniellage|Ncms|éniellage
annulement|Ncms|annulement
anoblissement|Ncms|anoblissement
ânonnement|Ncms|ânonnement
antéprédicament|Ncms|antéprédicament
anthropophage|Ncfs|anthropophage
anthropophage|Ncms|anthropophage
antiblocage|Ncms|antiblocage
antibrouillage|Ncms|antibrouillage
anticrénelage|Ncms|anticrénelage
anticrènelage|Ncms|anticrènelage
antidémarrage|Ncms|antidémarrage
antiferment|Ncms|antiferment
antiripage|Ncms|antiripage
aoûtage|Ncms|aoûtage
aoûtement|Ncms|aoûtement
aoutage|Ncms|aoutage
aoutement|Ncms|aoutement
épaillage|Ncms|épaillage
épaillement|Ncms|épaillement
apaisement|Ncms|apaisement
épaississement|Ncms|épaississement
épalement|Ncms|épalement
épamprage|Ncms|épamprage
épamprement|Ncms|épamprement
apanage|Ncms|apanage
épanchement|Ncms|épanchement
épandage|Ncms|épandage
épannelage|Ncms|épannelage
épannellement|Ncms|épannellement
épanouissement|Ncms|épanouissement
éparpillement|Ncms|éparpillement
apatelage|Ncms|apatelage
épaulement|Ncms|épaulement
éperonnement|Ncms|éperonnement
apetissement|Ncms|apetissement
épiçage|Ncms|épiçage
épiage|Ncms|épiage
épierrage|Ncms|épierrage
épierrement|Ncms|épierrement
épilage|Ncms|épilage
épinçage|Ncms|épinçage
épinage|Ncms|épinage
épincetage|Ncms|épincetage
épinglage|Ncms|épinglage
apiquage|Ncms|apiquage
épissage|Ncms|épissage
apitoiement|Ncms|apitoiement
aplanissement|Ncms|aplanissement
aplatissage|Ncms|aplatissage
aplatissement|Ncms|aplatissement
éplorement|Ncms|éplorement
épluchage|Ncms|épluchage
épointage|Ncms|épointage
épointement|Ncms|épointement
épointillage|Ncms|épointillage
épongeage|Ncms|épongeage
épontillage|Ncms|épontillage
apostement|Ncms|apostement
épouillage|Ncms|épouillage
époussètement|Ncms|époussètement
époussetage|Ncms|époussetage
époutiage|Ncms|époutiage
époutissage|Ncms|époutissage
épouvantement|Ncms|épouvantement
appairage|Ncms|appairage
appâlissement|Ncms|appâlissement
apparîement|Ncms|apparîement
appareillage|Ncms|appareillage
appareillement|Ncms|appareillement
apparentage|Ncms|apparentage
apparentement|Ncms|apparentement
appariage|Ncfs|appariage
appariement|Ncms|appariement
appartement|Ncms|appartement
appauvrissement|Ncms|appauvrissement
appendage|Ncms|appendage
appesantissement|Ncms|appesantissement
appiècement|Ncms|appiècement
appiécement|Ncms|appiécement
applaudissement|Ncms|applaudissement
applicage|Ncms|applicage
appointage|Ncms|appointage
appointement|Ncms|appointement
appointissage|Ncms|appointissage
appontage|Ncms|appontage
appontement|Ncms|appontement
apportage|Ncms|apportage
apportionnement|Ncms|apportionnement
apprêtage|Ncms|apprêtage
apprentissage|Ncms|apprentissage
apprivoisement|Ncms|apprivoisement
approfondissement|Ncms|approfondissement
approvisionnement|Ncms|approvisionnement
épreuvage|Ncms|épreuvage
épuisement|Ncms|épuisement
apurement|Ncms|apurement
aquaplanage|Ncms|aquaplanage
équarrissage|Ncms|équarrissage
équarrissement|Ncms|équarrissement
équasillement|Ncms|équasillement
équerrage|Ncms|équerrage
équeutage|Ncms|équeutage
équilibrage|Ncms|équilibrage
équipage|Ncms|équipage
équipement|Ncms|équipement
aréage|Ncms|aréage
éraflage|Ncms|éraflage
éraflement|Ncms|éraflement
éraillement|Ncms|éraillement
arçonnage|Ncms|arçonnage
aréopage|Ncms|aréopage
arasement|Ncms|arasement
arbelage|Ncms|arbelage
arbitrage|Ncms|arbitrage
archivage|Ncms|archivage
éreintage|Ncms|éreintage
éreintement|Ncms|éreintement
argentage|Ncms|argentage
argument|Ncms|argument
armement|Ncms|armement
arment|Ncms|arment
arpégement|Ncms|arpégement
arpègement|Ncms|arpègement
arpentage|Ncms|arpentage
arrêtement|Ncms|arrêtement
arrachage|Ncms|arrachage
arrachement|Ncms|arrachement
arraisonnement|Ncms|arraisonnement
arrangement|Ncms|arrangement
arrentement|Ncms|arrentement
arrhement|Ncms|arrhement
arrimage|Ncms|arrimage
arrivage|Ncms|arrivage
arrondissage|Ncms|arrondissage
arrondissement|Ncms|arrondissement
arrosage|Ncms|arrosage
arrosement|Ncms|arrosement
arsuintage|Ncms|arsuintage
érussage|Ncms|érussage
œsophage|Ncms|œsophage
ésouchement|Ncms|ésouchement
asphaltage|Ncms|asphaltage
asséchage|Ncms|asséchage
asséchement|Ncms|asséchement
assèchement|Ncms|assèchement
assagissement|Ncms|assagissement
assainissement|Ncms|assainissement
assaisonnement|Ncms|assaisonnement
assemblage|Ncms|assemblage
assemblement|Ncms|assemblement
assentiment|Ncms|assentiment
asservissement|Ncms|asservissement
assiégement|Ncms|assiégement
assiègement|Ncms|assiègement
assolement|Ncms|assolement
assombrissement|Ncms|assombrissement
assommement|Ncms|assommement
assortiment|Ncms|assortiment
assouchement|Ncms|assouchement
assoupissement|Ncms|assoupissement
assouplissement|Ncms|assouplissement
assourdissement|Ncms|assourdissement
assouvissement|Ncms|assouvissement
assujettissement|Ncms|assujettissement
assurage|Ncms|assurage
astinage|Ncms|astinage
astiquage|Ncms|astiquage
étêtage|Ncms|étêtage
étêtement|Ncms|étêtement
établage|Ncms|établage
établissement|Ncms|établissement
étagement|Ncms|étagement
étage|Ncms|étage
ôtage|Ncms|ôtage
étaiement|Ncms|étaiement
étaillissage|Ncms|étaillissage
étalage|Ncms|étalage
étalement|Ncms|étalement
étalonnage|Ncms|étalonnage
étalonnement|Ncms|étalonnement
étamage|Ncms|étamage
étampage|Ncms|étampage
étançonnement|Ncms|étançonnement
étanchement|Ncms|étanchement
étaupinage|Ncms|étaupinage
étayage|Ncms|étayage
éteignement|Ncms|éteignement
étendage|Ncms|étendage
atermoiement|Ncms|atermoiement
éternuement|Ncms|éternuement
éternument|Ncms|éternument
étiage|Ncms|étiage
étincèlement|Ncms|étincèlement
étincelage|Ncms|étincelage
étincellement|Ncms|étincellement
étiolement|Ncms|étiolement
étiquetage|Ncms|étiquetage
étirage|Ncms|étirage
étirement|Ncms|étirement
étocage|Ncms|étocage
étoffement|Ncms|étoffement
étonnement|Ncms|étonnement
étouffage|Ncms|étouffage
étouffement|Ncms|étouffement
étoupage|Ncms|étoupage
étoupement|Ncms|étoupement
étourdissement|Ncms|étourdissement
étrécissement|Ncms|étrécissement
étranglement|Ncms|étranglement
étrépage|Ncms|étrépage
étrésillonnement|Ncms|étrésillonnement
étricage|Ncms|étricage
étripage|Ncms|étripage
étriquement|Ncms|étriquement
attachement|Ncms|attachement
attérage|Ncms|attérage
atteignement|Ncms|atteignement
attelage|Ncms|attelage
attellement|Ncms|attellement
attendrissement|Ncms|attendrissement
atterrage|Ncms|atterrage
atterrement|Ncms|atterrement
atterripage|Ncfs|atterripage
atterrissage|Ncms|atterrissage
atterrissement|Ncms|atterrissement
attiédissement|Ncms|attiédissement
attifage|Ncms|attifage
attifement|Ncms|attifement
attinage|Ncms|attinage
attisement|Ncms|attisement
attouchement|Ncms|attouchement
attrempage|Ncms|attrempage
attroupement|Ncms|attroupement
étuvage|Ncms|étuvage
étuvement|Ncms|étuvement
aubage|Ncms|aubage
aubainage|Ncms|aubainage
aubenage|Ncms|aubenage
aubinage|Ncms|aubinage
augment|Ncms|augment
aunage|Ncms|aunage
aurilage|Ncms|aurilage
aurillage|Ncfs|aurillage
aurislage|Ncfs|aurislage
autoallumage|Ncms|autoallumage
autoarbitrage|Ncms|autoarbitrage
autocabrage|Ncms|autocabrage
autoclavage|Ncms|autoclavage
autodénigrement|Ncms|autodénigrement
autofinancement|Ncms|autofinancement
autoformatage|Ncms|autoformatage
automassage|Ncms|automassage
autopartage|Ncms|autopartage
autoréférencement|Ncms|autoréférencement
avachissement|Ncms|avachissement
avage|Ncms|avage
avalage|Ncfs|avalage
avalement|Ncms|avalement
avançage|Ncms|avançage
avénage|Ncms|avénage
avancement|Ncms|avancement
avénement|Ncms|avénement
avènement|Ncms|avènement
évènement|Ncms|évènement
événement|Ncms|événement
évanouissement|Ncms|évanouissement
avantage|Ncms|avantage
évasement|Ncms|évasement
éveillement|Ncms|éveillement
éveinage|Ncms|éveinage
éventage|Ncms|éventage
éventement|Ncms|éventement
éventrement|Ncms|éventrement
avertissement|Ncms|avertissement
aveuglement|Ncms|aveuglement
aveulissement|Ncms|aveulissement
évidage|Ncms|évidage
évidement|Ncms|évidement
avilissement|Ncms|avilissement
avinage|Ncms|avinage
évincement|Ncms|évincement
évitage|Ncfs|évitage
évitage|Ncms|évitage
évitement|Ncms|évitement
avivage|Ncms|avivage
avivement|Ncms|avivement
évolage|Ncms|évolage
avortement|Ncms|avortement
azurage|Ncms|azurage
azurement|Ncms|azurement
bêchage|Ncms|bêchage
bêchement|Ncms|bêchement
bêlement|Ncms|bêlement
bêtifiage|Ncms|bêtifiage
babillage|Ncms|babillage
babillement|Ncms|babillement
bâchage|Ncms|bâchage
bûchement|Ncms|bûchement
bûcheronnage|Ncms|bûcheronnage
bachotage|Ncms|bachotage
backstage|Ncms|backstage
baclage|Ncms|baclage
bâclage|Ncms|bâclage
bactériophage|Ncms|bactériophage
badaudage|Ncms|badaudage
badgeage|Ncms|badgeage
badigeonnage|Ncms|badigeonnage
badinage|Ncms|badinage
bafouement|Ncms|bafouement
bafouillage|Ncms|bafouillage
bagage|Ncms|bagage
bégaiement|Ncms|bégaiement
bégayement|Ncms|bégayement
bagossage|Ncms|bagossage
bagotage|Ncms|bagotage
bagotement|Ncms|bagotement
baguage|Ncms|baguage
béguètement|Ncms|béguètement
béguinage|Ncms|béguinage
bahutage|Ncms|bahutage
bâillement|Ncms|bâillement
bailliage|Ncms|bailliage
bâillonnement|Ncms|bâillonnement
baisage|Ncms|baisage
baisement|Ncms|baisement
baissement|Ncms|baissement
baladinage|Ncms|baladinage
balaiement|Ncms|balaiement
balancement|Ncms|balancement
balayage|Ncms|balayage
balayement|Ncms|balayement
balbutiement|Ncms|balbutiement
balisage|Ncms|balisage
balivage|Ncms|balivage
ballage|Ncms|ballage
ballastage|Ncms|ballastage
ballonnement|Ncms|ballonnement
ballotage|Ncms|ballotage
ballotement|Ncms|ballotement
ballottage|Ncms|ballottage
ballottement|Ncms|ballottement
bénéficiement|Ncms|bénéficiement
bénatage|Ncms|bénatage
bandage|Ncms|bandage
bandinement|Ncms|bandinement
bénissage|Ncms|bénissage
bannissement|Ncms|bannissement
baquetage|Ncms|baquetage
béquillage|Ncms|béquillage
baragouinage|Ncms|baragouinage
baraquage|Ncms|baraquage
baraquement|Ncms|baraquement
barattage|Ncms|barattage
barbarouffement|Ncms|barbarouffement
barbonnage|Ncms|barbonnage
barbotage|Ncms|barbotage
barbotement|Ncms|barbotement
barbouillage|Ncms|barbouillage
bardage|Ncms|bardage
barguignage|Ncms|barguignage
barillage|Ncms|barillage
bariolage|Ncms|bariolage
barnage|Ncms|barnage
baronnage|Ncms|baronnage
barrage|Ncms|barrage
barreaudage|Ncms|barreaudage
barrissement|Ncms|barrissement
barrotage|Ncms|barrotage
barrottage|Ncms|barrottage
basage|Ncms|basage
basculement|Ncms|basculement
bassage|Ncms|bassage
bassinage|Ncms|bassinage
bassinement|Ncms|bassinement
bassotage|Ncms|bassotage
bastingage|Ncms|bastingage
bâtage|Ncms|bâtage
batelage|Ncms|batelage
batellement|Ncms|batellement
batifolage|Ncms|batifolage
batillage|Ncms|batillage
Bâtiment|Ncms|Bâtiment
bâtiment|Ncms|bâtiment
bâtissage|Ncms|bâtissage
bâtonnage|Ncms|bâtonnage
bétonnage|Ncms|bétonnage
battage|Ncms|battage
battellement|Ncms|battellement
battement|Ncms|battement
bœuvonnage|Ncms|bœuvonnage
bavardage|Ncms|bavardage
becquetage|Ncms|becquetage
belutage|Ncms|belutage
bercement|Ncms|bercement
bernement|Ncms|bernement
bertillonnage|Ncms|bertillonnage
beuglement|Ncms|beuglement
biaisement|Ncms|biaisement
biberonnage|Ncms|biberonnage
bibliophage|Ncfs|bibliophage
bibliophage|Ncms|bibliophage
bichetage|Ncms|bichetage
bichromatage|Ncms|bichromatage
bidonnage|Ncms|bidonnage
bidouillage|Ncms|bidouillage
bienvenutage|Ncms|bienvenutage
biffage|Ncms|biffage
bigarrement|Ncms|bigarrement
billage|Ncms|billage
billetage|Ncms|billetage
billonnage|Ncms|billonnage
binage|Ncms|binage
binotage|Ncms|binotage
bioélément|Ncms|bioélément
biorevêtement|Ncms|biorevêtement
biotraitement|Ncms|biotraitement
bipage|Ncms|bipage
bisage|Ncms|bisage
biseautage|Ncms|biseautage
bisellement|Ncms|bisellement
bistournage|Ncms|bistournage
bistournement|Ncms|bistournement
bitumage|Ncms|bitumage
bizounage|Ncms|bizounage
bizutage|Ncms|bizutage
blêmissement|Ncms|blêmissement
blackboulage|Ncms|blackboulage
blacklistage|Ncms|blacklistage
bladage|Ncms|bladage
blaisement|Ncms|blaisement
blémissement|Ncms|blémissement
blanchîment|Ncms|blanchîment
blanchiment|Ncms|blanchiment
blanchissage|Ncms|blanchissage
blanchissement|Ncms|blanchissement
blasement|Ncms|blasement
blèsement|Ncms|blèsement
blésement|Ncms|blésement
blasonnement|Ncms|blasonnement
blastophage|Ncms|blastophage
bleuissage|Ncms|bleuissage
bleuissement|Ncms|bleuissement
bleutage|Ncms|bleutage
blindage|Ncms|blindage
blocage|Ncms|blocage
blondoîment|Ncms|blondoîment
blondoiement|Ncms|blondoiement
blutage|Ncms|blutage
boîtage|Ncms|boîtage
boîtement|Ncms|boîtement
bobinage|Ncms|bobinage
bocage|Ncms|bocage
bocardage|Ncms|bocardage
boisage|Ncms|boisage
boisement|Ncms|boisement
boitage|Ncms|boitage
boitement|Ncms|boitement
bolidage|Ncms|bolidage
bombage|Ncms|bombage
bombardement|Ncms|bombardement
bombement|Ncms|bombement
bondage|Ncms|bondage
bondissement|Ncms|bondissement
boniment|Ncms|boniment
bordage|Ncms|bordage
borinage|Ncms|borinage
bornage|Ncms|bornage
bossage|Ncms|bossage
bosselage|Ncms|bosselage
botage|Ncms|botage
bottelage|Ncms|bottelage
boucage|Ncms|boucage
boucanage|Ncms|boucanage
bouchage|Ncms|bouchage
bouchardage|Ncms|bouchardage
bouchonnage|Ncms|bouchonnage
bouchonnement|Ncms|bouchonnement
bouclage|Ncms|bouclage
boudinage|Ncms|boudinage
bougeage|Ncms|bougeage
bougonnement|Ncms|bougonnement
bouillonnement|Ncms|bouillonnement
bouillotement|Ncms|bouillotement
boulage|Ncms|boulage
bouleversement|Ncms|bouleversement
boulonnage|Ncms|boulonnage
bouquinage|Ncms|bouquinage
bourdonnement|Ncms|bourdonnement
bourgage|Ncms|bourgage
bourgeonnement|Ncms|bourgeonnement
bourrage|Ncms|bourrage
bourrèlement|Ncms|bourrèlement
boursicotage|Ncms|boursicotage
boursillement|Ncms|boursillement
boursoufflage|Ncms|boursoufflage
boursoufflement|Ncms|boursoufflement
boursouflage|Ncms|boursouflage
boursouflement|Ncms|boursouflement
bousage|Ncms|bousage
bousillage|Ncms|bousillage
boutage|Ncms|boutage
bouteillage|Ncms|bouteillage
boutonnage|Ncms|boutonnage
boutonnement|Ncms|boutonnement
bouturage|Ncms|bouturage
bouvement|Ncms|bouvement
bouvetage|Ncms|bouvetage
brêlage|Ncms|brêlage
braîment|Ncms|braîment
brébiage|Ncms|brébiage
bracage|Ncms|bracage
brachyœsophage|Ncms|brachyœsophage
braconnage|Ncms|braconnage
brédissage|Ncms|brédissage
braiement|Ncms|braiement
braillement|Ncms|braillement
braiment|Ncms|braiment
braisage|Ncms|braisage
brélage|Ncms|brélage
brûlage|Ncms|brûlage
brûlement|Ncms|brûlement
bramement|Ncms|bramement
brancardage|Ncms|brancardage
branchage|Ncms|branchage
branchement|Ncms|branchement
brandissement|Ncms|brandissement
branlement|Ncms|branlement
braquage|Ncms|braquage
brasage|Ncms|brasage
brasement|Ncms|brasement
brasillement|Ncms|brasillement
brassage|Ncms|brassage
brasséyage|Ncms|brasséyage
brassiage|Ncms|brassiage
brebiage|Ncms|brebiage
bredouillage|Ncms|bredouillage
bredouillement|Ncms|bredouillement
brelandage|Ncms|brelandage
brellage|Ncms|brellage
breuvage|Ncms|breuvage
brevetage|Ncms|brevetage
bricolage|Ncms|bricolage
bridage|Ncms|bridage
bridement|Ncms|bridement
brigandage|Ncms|brigandage
brimbalement|Ncms|brimbalement
briquetage|Ncms|briquetage
brisement|Ncms|brisement
brocantage|Ncms|brocantage
brochage|Ncms|brochage
broiement|Ncms|broiement
bronchement|Ncms|bronchement
brondissage|Ncms|brondissage
brondissement|Ncms|brondissement
bronzage|Ncms|bronzage
brossage|Ncms|brossage
brouettage|Ncms|brouettage
brouillage|Ncms|brouillage
brouillement|Ncms|brouillement
broussaillement|Ncms|broussaillement
broutage|Ncms|broutage
broutement|Ncms|broutement
broyage|Ncms|broyage
bruinement|Ncms|bruinement
bruissement|Ncms|bruissement
bruitage|Ncms|bruitage
brulage|Ncms|brulage
brulement|Ncms|brulement
brunissage|Ncms|brunissage
brunissement|Ncms|brunissement
brutage|Ncms|brutage
bucheronnage|Ncms|bucheronnage
buffêtement|Ncms|buffêtement
buffetage|Ncms|buffetage
bulletinage|Ncms|bulletinage
burelage|Ncms|burelage
butage|Ncms|butage
butinement|Ncms|butinement
buttage|Ncms|buttage
cabanement|Ncms|cabanement
câblage|Ncms|câblage
cabossage|Ncms|cabossage
cabotage|Ncms|cabotage
cabotinage|Ncms|cabotinage
cachement|Ncms|cachement
cachetage|Ncms|cachetage
cachiment|Ncms|cachiment
cadastrage|Ncms|cadastrage
cadencement|Ncms|cadencement
cadmiage|Ncms|cadmiage
cadrage|Ncms|cadrage
cafardage|Ncms|cafardage
cafouillage|Ncms|cafouillage
cafutage|Ncms|cafutage
cage|Ncfs|cage
cagnottage|Ncms|cagnottage
cahotage|Ncms|cahotage
cahotement|Ncms|cahotement
caillage|Ncms|caillage
caillassage|Ncms|caillassage
cailletage|Ncms|cailletage
cailloutage|Ncms|cailloutage
calage|Ncms|calage
calament|Ncms|calament
calaminage|Ncms|calaminage
calandrage|Ncms|calandrage
calendage|Ncms|calendage
calepinage|Ncms|calepinage
calfatage|Ncms|calfatage
calfeutrage|Ncms|calfeutrage
calfeutrement|Ncms|calfeutrement
calibrage|Ncms|calibrage
calicotage|Ncms|calicotage
calinage|Ncms|calinage
callage|Ncms|callage
calorifugeage|Ncms|calorifugeage
calquage|Ncms|calquage
camage|Ncms|camage
cambage|Ncms|cambage
cambrage|Ncms|cambrage
cambrelage|Ncms|cambrelage
cambrement|Ncms|cambrement
cambriolage|Ncms|cambriolage
cément|Ncms|cément
camionnage|Ncms|camionnage
camouflage|Ncms|camouflage
campement|Ncms|campement
canardage|Ncms|canardage
cannage|Ncms|cannage
canonnage|Ncms|canonnage
canotage|Ncms|canotage
cantonnement|Ncms|cantonnement
caoutchoutage|Ncms|caoutchoutage
cépage|Ncms|cépage
capelage|Ncms|capelage
capitonnage|Ncms|capitonnage
capotage|Ncms|capotage
capsage|Ncms|capsage
capsulage|Ncms|capsulage
captage|Ncms|captage
capuchonnement|Ncms|capuchonnement
caquètement|Ncms|caquètement
caquetage|Ncms|caquetage
carabinage|Ncms|carabinage
carémage|Ncms|carémage
carambolage|Ncms|carambolage
carambouillage|Ncms|carambouillage
carénage|Ncms|carénage
caratage|Ncms|caratage
caravanage|Ncms|caravanage
cardage|Ncms|cardage
carillonnement|Ncms|carillonnement
carnage|Ncms|carnage
carottage|Ncms|carottage
carpophage|Ncms|carpophage
carreaudage|Ncms|carreaudage
carrelage|Ncms|carrelage
carrossage|Ncms|carrossage
carroyage|Ncms|carroyage
cartelage|Ncms|cartelage
cartilage|Ncms|cartilage
cartonnage|Ncms|cartonnage
cérusage|Ncms|cérusage
casernement|Ncms|casernement
cassage|Ncms|cassage
cassement|Ncms|cassement
catalogage|Ncms|catalogage
cataloguement|Ncms|cataloguement
catapultage|Ncms|catapultage
catissage|Ncms|catissage
cautionnement|Ncms|cautionnement
cavage|Ncms|cavage
caviardage|Ncms|caviardage
ceintrage|Ncms|ceintrage
ceinturage|Ncms|ceinturage
cellérage|Ncms|cellérage
cellerage|Ncms|cellerage
cellulage|Ncms|cellulage
centrage|Ncms|centrage
cerclage|Ncms|cerclage
cerclemenage|Ncms|cerclemenage
cernement|Ncms|cernement
cerquemannage|Ncms|cerquemannage
chaînage|Ncms|chaînage
chabannage|Ncms|chabannage
chafouinage|Ncms|chafouinage
chainage|Ncms|chainage
chalandage|Ncms|chalandage
chalutage|Ncms|chalutage
chômage|Ncms|chômage
chambardement|Ncms|chambardement
chambellage|Ncms|chambellage
chambonnage|Ncms|chambonnage
chamboulement|Ncms|chamboulement
chambrage|Ncms|chambrage
chamoisage|Ncms|chamoisage
champéage|Ncms|champéage
champlevage|Ncms|champlevage
chancèlement|Ncms|chancèlement
chancellement|Ncms|chancellement
changement|Ncms|changement
chantage|Ncms|chantage
chantelage|Ncms|chantelage
chantonnement|Ncms|chantonnement
chantournage|Ncms|chantournage
chantournement|Ncms|chantournement
chapardage|Ncms|chapardage
chaperonnage|Ncms|chaperonnage
chaponnage|Ncms|chaponnage
charbonnage|Ncms|charbonnage
charcutage|Ncms|charcutage
chargeage|Ncms|chargeage
chargement|Ncms|chargement
chariotage|Ncms|chariotage
charpentage|Ncms|charpentage
charriage|Ncms|charriage
charriotage|Ncms|charriotage
charronnage|Ncms|charronnage
charroyage|Ncms|charroyage
charruage|Ncms|charruage
chassage|Ncms|chassage
chassement|Ncms|chassement
châtiment|Ncms|châtiment
chatoiement|Ncms|chatoiement
chatouillement|Ncms|chatouillement
chatoyement|Ncms|chatoyement
châtrage|Ncms|châtrage
chaubage|Ncms|chaubage
chauffage|Ncms|chauffage
chaulage|Ncms|chaulage
chaumage|Ncms|chaumage
chausséage|Ncms|chausséage
chaussage|Ncms|chaussage
chavirage|Ncms|chavirage
chavirement|Ncms|chavirement
chemérage|Ncms|chemérage
chemicage|Ncms|chemicage
cheminement|Ncms|cheminement
chemisage|Ncms|chemisage
chenalage|Ncms|chenalage
chevage|Ncms|chevage
chevalement|Ncms|chevalement
chevauchement|Ncms|chevauchement
chevelage|Ncms|chevelage
chevronnage|Ncms|chevronnage
chevrotage|Ncms|chevrotage
chevrotement|Ncms|chevrotement
chicayage|Ncms|chicayage
chiffonnage|Ncms|chiffonnage
chiffrage|Ncms|chiffrage
chiffrement|Ncms|chiffrement
chignonage|Ncms|chignonage
chinage|Ncms|chinage
chipage|Ncms|chipage
chipotage|Ncms|chipotage
chiquetage|Ncms|chiquetage
chlorage|Ncms|chlorage
choppement|Ncms|choppement
choquement|Ncms|choquement
chouchement|Ncms|chouchement
chougnement|Ncms|chougnement
chouravage|Ncms|chouravage
chromage|Ncms|chromage
chroniquage|Ncms|chroniquage
chronométrage|Ncms|chronométrage
chuchotage|Ncms|chuchotage
chuchotement|Ncms|chuchotement
chuintement|Ncms|chuintement
ciblage|Ncms|ciblage
cillement|Ncms|cillement
cimentage|Ncms|cimentage
ciment|Ncms|ciment
cinglage|Ncms|cinglage
cintrage|Ncms|cintrage
cirage|Ncms|cirage
cirement|Ncms|cirement
cisaillement|Ncms|cisaillement
cisèlement|Ncms|cisèlement
cisellement|Ncms|cisellement
clabaudage|Ncms|clabaudage
clabotage|Ncms|clabotage
clampage|Ncms|clampage
clapotage|Ncms|clapotage
clapotement|Ncms|clapotement
clappement|Ncms|clappement
claquage|Ncms|claquage
claquement|Ncms|claquement
classement|Ncms|classement
clavardage|Ncms|clavardage
clavetage|Ncms|clavetage
clayonnage|Ncms|clayonnage
clichage|Ncms|clichage
clignement|Ncms|clignement
clignotement|Ncms|clignotement
clinchage|Ncms|clinchage
clissage|Ncms|clissage
clivage|Ncms|clivage
clochement|Ncms|clochement
cloisonnage|Ncms|cloisonnage
cloisonnement|Ncms|cloisonnement
clonage|Ncms|clonage
clouage|Ncms|clouage
cloutage|Ncms|cloutage
coassement|Ncms|coassement
coétalement|Ncms|coétalement
cochenillage|Ncms|cochenillage
coconnage|Ncms|coconnage
cocuage|Ncms|cocuage
cocufiage|Ncms|cocufiage
codage|Ncms|codage
coffrage|Ncms|coffrage
cofrittage|Ncms|cofrittage
cognement|Ncms|cognement
cogriffage|Ncms|cogriffage
coiffage|Ncms|coiffage
coignage|Ncms|coignage
coinçage|Ncms|coinçage
coincement|Ncms|coincement
cokage|Ncms|cokage
colisage|Ncms|colisage
collage|Ncms|collage
collationnement|Ncms|collationnement
collement|Ncms|collement
colletage|Ncms|colletage
collimage|Ncms|collimage
colmatage|Ncms|colmatage
colombage|Ncms|colombage
colonage|Ncms|colonage
colonnage|Ncms|colonnage
coloriage|Ncms|coloriage
colportage|Ncms|colportage
coltinage|Ncms|coltinage
comblement|Ncms|comblement
commandement|Ncms|commandement
commérage|Ncms|commérage
commencement|Ncms|commencement
comment|Ncmp|comment
comment|Ncms|comment
commettage|Ncms|commettage
compactage|Ncms|compactage
compagnonnage|Ncms|compagnonnage
compérage|Ncms|compérage
compartimentage|Ncms|compartimentage
compartiment|Ncms|compartiment
compassement|Ncms|compassement
complément|Ncms|complément
complètement|Ncms|complètement
complétement|Ncms|complétement
complexage|Ncms|complexage
compliment|Ncms|compliment
complotage|Ncms|complotage
comportement|Ncms|comportement
compostage|Ncms|compostage
compoundage|Ncms|compoundage
comptage|Ncms|comptage
concassage|Ncms|concassage
concentrement|Ncms|concentrement
conchage|Ncms|conchage
concubinage|Ncms|concubinage
condiment|Ncms|condiment
conditionnement|Ncms|conditionnement
confinement|Ncms|confinement
confortement|Ncms|confortement
congément|Ncms|congément
congréage|Ncms|congréage
connaissement|Ncms|connaissement
consentement|Ncms|consentement
consolidement|Ncms|consolidement
contage|Ncms|contage
contentement|Ncms|contentement
contingentement|Ncms|contingentement
contournement|Ncms|contournement
contraignement|Ncms|contraignement
contrôlage|Ncms|contrôlage
contrôlement|Ncms|contrôlement
contrebutement|Ncms|contrebutement
contremandement|Ncms|contremandement
contreplacage|Ncms|contreplacage
contretypage|Ncms|contretypage
contreventement|Ncms|contreventement
conventionnement|Ncms|conventionnement
convertissement|Ncms|convertissement
convoiement|Ncms|convoiement
convoyage|Ncms|convoyage
coparrainage|Ncms|coparrainage
copiage|Ncms|copiage
copillage|Ncms|copillage
copinage|Ncms|copinage
coquillage|Ncms|coquillage
corbeillage|Ncms|corbeillage
cordage|Ncms|cordage
cordelage|Ncms|cordelage
cornage|Ncms|cornage
cornement|Ncms|cornement
corrigement|Ncms|corrigement
corroyage|Ncms|corroyage
corsage|Ncms|corsage
corsetage|Ncms|corsetage
cotonnage|Ncms|cotonnage
cottage|Ncms|cottage
couchage|Ncms|couchage
coudoiement|Ncms|coudoiement
coudrement|Ncms|coudrement
couinement|Ncms|couinement
coulage|Ncms|coulage
coulinage|Ncms|coulinage
coupage|Ncms|coupage
couplage|Ncms|couplage
couponnage|Ncms|couponnage
courage|Ncms|courage
courbage|Ncms|courbage
courbement|Ncms|courbement
couronnement|Ncms|couronnement
courtage|Ncms|courtage
cousinage|Ncms|cousinage
couvrement|Ncms|couvrement
covoiturage|Ncms|covoiturage
coyautage|Ncms|coyautage
crêpage|Ncms|crêpage
crébillonnage|Ncms|crébillonnage
crabotage|Ncms|crabotage
crachement|Ncms|crachement
crachotement|Ncms|crachotement
crémage|Ncms|crémage
crément|Ncms|crément
cramponnement|Ncms|cramponnement
cranage|Ncms|cranage
crénage|Ncms|crénage
crènelage|Ncms|crènelage
crénelage|Ncms|crénelage
crantage|Ncms|crantage
créosotage|Ncms|créosotage
crépage|Ncms|crépage
crépelage|Ncms|crépelage
crépissage|Ncms|crépissage
crépitement|Ncms|crépitement
craquage|Ncms|craquage
craquètement|Ncms|craquètement
craquelage|Ncms|craquelage
craquement|Ncms|craquement
crassement|Ncms|crassement
crayonnage|Ncms|crayonnage
creusage|Ncms|creusage
creusement|Ncms|creusement
criage|Ncms|criage
criaillement|Ncms|criaillement
criblage|Ncms|criblage
crissement|Ncms|crissement
croassement|Ncms|croassement
crochetage|Ncms|crochetage
croisement|Ncms|croisement
croisillonnage|Ncms|croisillonnage
croondage|Ncms|croondage
croondement|Ncms|croondement
croquement|Ncms|croquement
croskillage|Ncms|croskillage
croulement|Ncms|croulement
croupionnement|Ncms|croupionnement
croupissement|Ncms|croupissement
crucifiement|Ncms|crucifiement
cryptage|Ncms|cryptage
cubage|Ncms|cubage
cueillement|Ncms|cueillement
cuirassage|Ncms|cuirassage
cuirassement|Ncms|cuirassement
cuisage|Ncms|cuisage
cuissage|Ncms|cuissage
cuivrage|Ncms|cuivrage
culassement|Ncms|culassement
culbutage|Ncms|culbutage
culement|Ncms|culement
culletage|Ncms|culletage
culottage|Ncms|culottage
curage|Ncms|curage
curement|Ncms|curement
curetage|Ncms|curetage
curettage|Ncms|curettage
cuvage|Ncms|cuvage
cuvelage|Ncms|cuvelage
cuvellement|Ncms|cuvellement
cyanophage|Ncms|cyanophage
cyberharcèlement|Ncms|cyberharcèlement
cybersquattage|Ncms|cybersquattage
cylindrage|Ncms|cylindrage
débécage|Ncms|débécage
débâclage|Ncms|débâclage
débâclement|Ncms|débâclement
débagoulage|Ncms|débagoulage
débalancement|Ncms|débalancement
déballage|Ncms|déballage
déballastage|Ncms|déballastage
débandement|Ncms|débandement
débaraquement|Ncms|débaraquement
débarbouillage|Ncms|débarbouillage
débardage|Ncms|débardage
débarquage|Ncms|débarquage
débarquement|Ncms|débarquement
débarrassage|Ncms|débarrassage
débarrassement|Ncms|débarrassement
débastillement|Ncms|débastillement
débatelage|Ncms|débatelage
débattement|Ncms|débattement
débauchage|Ncms|débauchage
débauchement|Ncms|débauchement
débecquage|Ncms|débecquage
débillardement|Ncms|débillardement
débinage|Ncms|débinage
débitage|Ncms|débitage
déblacklistage|Ncms|déblacklistage
déblaiement|Ncms|déblaiement
déblayage|Ncms|déblayage
déblayement|Ncms|déblayement
déblocage|Ncms|déblocage
débloquement|Ncms|débloquement
déboîtage|Ncms|déboîtage
déboîtement|Ncms|déboîtement
débobinage|Ncms|débobinage
débogage|Ncms|débogage
déboisage|Ncms|déboisage
déboisement|Ncms|déboisement
déboitement|Ncms|déboitement
débondage|Ncms|débondage
débondonnement|Ncms|débondonnement
débordement|Ncms|débordement
débosquage|Ncms|débosquage
débosselage|Ncms|débosselage
débouchage|Ncms|débouchage
débouchement|Ncms|débouchement
débouillissage|Ncms|débouillissage
déboulonnage|Ncms|déboulonnage
déboulonnement|Ncms|déboulonnement
débouquement|Ncms|débouquement
débourbage|Ncms|débourbage
débourrage|Ncms|débourrage
débourrement|Ncms|débourrement
déboursement|Ncms|déboursement
déboutement|Ncms|déboutement
déboutonnage|Ncms|déboutonnage
débraillage|Ncms|débraillage
débraillement|Ncms|débraillement
débraisage|Ncms|débraisage
débraisement|Ncms|débraisement
débranchement|Ncms|débranchement
débrayage|Ncms|débrayage
débridage|Ncms|débridage
débridement|Ncms|débridement
débrochage|Ncms|débrochage
débrouillage|Ncms|débrouillage
débrouillement|Ncms|débrouillement
débroussaillage|Ncms|débroussaillage
débroussaillement|Ncfs|débroussaillement
débrumage|Ncms|débrumage
débrutissement|Ncms|débrutissement
débuttage|Ncms|débuttage
décachètement|Ncms|décachètement
décachetage|Ncms|décachetage
décaissage|Ncms|décaissage
décaissement|Ncms|décaissement
décalage|Ncms|décalage
décalaminage|Ncms|décalaminage
décèlement|Ncms|décèlement
décalquage|Ncms|décalquage
décampement|Ncms|décampement
décantage|Ncms|décantage
décantonnement|Ncms|décantonnement
décapage|Ncms|décapage
décapèlement|Ncms|décapèlement
décapelage|Ncms|décapelage
décapsulage|Ncms|décapsulage
décarrelage|Ncms|décarrelage
décasement|Ncms|décasement
décatissage|Ncms|décatissage
décavaillonnage|Ncms|décavaillonnage
décentrage|Ncms|décentrage
décentrement|Ncms|décentrement
décernement|Ncms|décernement
décervelage|Ncms|décervelage
déchaînement|Ncms|déchaînement
déchainement|Ncms|déchainement
déchalement|Ncms|déchalement
déchargeage|Ncms|déchargeage
déchargement|Ncms|déchargement
décharnement|Ncms|décharnement
déchaumage|Ncms|déchaumage
déchaussage|Ncms|déchaussage
déchaussement|Ncms|déchaussement
déchiffrage|Ncms|déchiffrage
déchiffrement|Ncms|déchiffrement
déchiquetage|Ncms|déchiquetage
déchirage|Ncms|déchirage
déchirement|Ncms|déchirement
déchocage|Ncms|déchocage
déchouement|Ncms|déchouement
décilage|Ncms|décilage
décintrage|Ncms|décintrage
décintrement|Ncms|décintrement
déclassement|Ncms|déclassement
déclenchement|Ncms|déclenchement
déclinement|Ncms|déclinement
décliquetage|Ncms|décliquetage
décloisonnement|Ncms|décloisonnement
décochage|Ncms|décochage
décochement|Ncms|décochement
décoconnage|Ncms|décoconnage
décodage|Ncms|décodage
décoffrage|Ncms|décoffrage
décoiffage|Ncms|décoiffage
décoiffement|Ncms|décoiffement
décoinçage|Ncms|décoinçage
décoincement|Ncms|décoincement
décollage|Ncms|décollage
décollement|Ncms|décollement
décolletage|Ncms|décolletage
décomblement|Ncms|décomblement
décommettage|Ncms|décommettage
décompactage|Ncms|décompactage
décomptage|Ncms|décomptage
déconcertement|Ncms|déconcertement
déconditionnement|Ncms|déconditionnement
décongestionnement|Ncms|décongestionnement
décordonnage|Ncms|décordonnage
décorement|Ncms|décorement
décorticage|Ncms|décorticage
décottage|Ncms|décottage
découchage|Ncms|découchage
découennage|Ncms|découennage
découlement|Ncms|découlement
découpage|Ncms|découpage
découplage|Ncms|découplage
découragement|Ncms|découragement
découronnement|Ncms|découronnement
découvrement|Ncms|découvrement
décrêpage|Ncms|décrêpage
décrabotage|Ncms|décrabotage
décréditement|Ncms|décréditement
décrémage|Ncms|décrémage
décrûment|Ncms|décrûment
décrépissage|Ncms|décrépissage
décrassage|Ncms|décrassage
décrassement|Ncms|décrassement
décreusage|Ncms|décreusage
décroûtage|Ncms|décroûtage
décrochage|Ncms|décrochage
décrochement|Ncms|décrochement
décroisement|Ncms|décroisement
décroissement|Ncms|décroissement
décrottage|Ncms|décrottage
décruage|Ncms|décruage
décrusage|Ncms|décrusage
décrusement|Ncms|décrusement
décryptage|Ncms|décryptage
décuirassement|Ncms|décuirassement
déculassement|Ncms|déculassement
déculottage|Ncms|déculottage
décuscutage|Ncms|décuscutage
décuvage|Ncms|décuvage
décyclage|Ncms|décyclage
dédommagement|Ncms|dédommagement
dédorage|Ncms|dédorage
dédossement|Ncms|dédossement
dédouanement|Ncms|dédouanement
dédoublage|Ncms|dédoublage
dédoublement|Ncms|dédoublement
défacement|Ncms|défacement
défaillement|Ncms|défaillement
défanage|Ncms|défanage
déferlage|Ncms|déferlage
déferlement|Ncms|déferlement
déferrage|Ncms|déferrage
déferrement|Ncms|déferrement
défeuillage|Ncms|défeuillage
défeutrage|Ncms|défeutrage
défibrage|Ncms|défibrage
défichage|Ncms|défichage
défilage|Ncms|défilage
défilement|Ncms|défilement
défilochage|Ncms|défilochage
défonçage|Ncms|défonçage
défoncement|Ncms|défoncement
défoulement|Ncms|défoulement
défournage|Ncms|défournage
défournement|Ncms|défournement
défraiement|Ncms|défraiement
défrayement|Ncms|défrayement
défrichage|Ncms|défrichage
défrichement|Ncms|défrichement
défrisage|Ncms|défrisage
défrisement|Ncms|défrisement
défroncement|Ncms|défroncement
dégagement|Ncms|dégagement
dégalage|Ncms|dégalage
dégèlement|Ncms|dégèlement
dégarage|Ncms|dégarage
dégarnissage|Ncms|dégarnissage
dégarnissement|Ncms|dégarnissement
dégasolinage|Ncms|dégasolinage
dégauchissage|Ncms|dégauchissage
dégauchissement|Ncms|dégauchissement
dégazage|Ncms|dégazage
dégazement|Ncms|dégazement
dégazolinage|Ncms|dégazolinage
dégazonnement|Ncms|dégazonnement
dégivrage|Ncms|dégivrage
dégluement|Ncms|dégluement
dégoûtage|Ncms|dégoûtage
dégobillage|Ncms|dégobillage
dégommage|Ncms|dégommage
dégonflage|Ncms|dégonflage
dégonflement|Ncms|dégonflement
dégorgeage|Ncms|dégorgeage
dégorgement|Ncms|dégorgement
dégoudronnage|Ncms|dégoudronnage
dégoulinement|Ncms|dégoulinement
dégourdissement|Ncms|dégourdissement
dégoutage|Ncms|dégoutage
dégouttement|Ncms|dégouttement
dégréage|Ncms|dégréage
dégrêlage|Ncms|dégrêlage
dégréement|Ncms|dégréement
dégraissage|Ncms|dégraissage
dégraissement|Ncms|dégraissement
dégrénage|Ncms|dégrénage
dégrèvement|Ncms|dégrèvement
dégravoiement|Ncms|dégravoiement
dégrillage|Ncms|dégrillage
dégrisement|Ncms|dégrisement
dégrossage|Ncms|dégrossage
dégrossissage|Ncms|dégrossissage
dégrossissement|Ncms|dégrossissement
dégroupage|Ncms|dégroupage
dégroupement|Ncms|dégroupement
déguerpissement|Ncms|déguerpissement
daguerréotypage|Ncms|daguerréotypage
dégueulage|Ncms|dégueulage
déguisement|Ncms|déguisement
déhanchement|Ncms|déhanchement
déharnachement|Ncms|déharnachement
déhouillement|Ncms|déhouillement
déjaugeage|Ncms|déjaugeage
déjaugement|Ncms|déjaugement
déjettement|Ncms|déjettement
déjoutement|Ncms|déjoutement
délabrement|Ncms|délabrement
délainage|Ncms|délainage
délaissement|Ncms|délaissement
délaitage|Ncms|délaitage
délaitement|Ncms|délaitement
délampourdage|Ncms|délampourdage
délardement|Ncms|délardement
délassement|Ncms|délassement
délavage|Ncms|délavage
délayage|Ncms|délayage
délayement|Ncms|délayement
délestage|Ncms|délestage
déliement|Ncms|déliement
délignage|Ncms|délignage
délinéament|Ncms|délinéament
délissage|Ncms|délissage
délitage|Ncms|délitage
dallage|Ncms|dallage
délogement|Ncms|délogement
délogotage|Ncms|délogotage
délustrage|Ncms|délustrage
délutage|Ncms|délutage
démêlage|Ncms|démêlage
déméchage|Ncms|déméchage
démaclage|Ncms|démaclage
damage|Ncms|damage
démaigrissement|Ncms|démaigrissement
déménagement|Ncms|déménagement
démanchement|Ncms|démanchement
démantèlement|Ncms|démantèlement
démaquillage|Ncms|démaquillage
démarcage|Ncms|démarcage
démarchage|Ncms|démarchage
démariage|Ncms|démariage
démarquage|Ncms|démarquage
démarquement|Ncms|démarquement
démarrage|Ncms|démarrage
démasclage|Ncms|démasclage
damasquinage|Ncms|damasquinage
démasselotage|Ncms|démasselotage
démasselottage|Ncms|démasselottage
démastiquage|Ncms|démastiquage
démâtage|Ncms|démâtage
démâtement|Ncms|démâtement
démembrement|Ncms|démembrement
dément|Ncms|dément
démergement|Ncms|démergement
démeublement|Ncms|démeublement
déminage|Ncms|déminage
démolissage|Ncms|démolissage
démontage|Ncms|démontage
démouchetage|Ncms|démouchetage
démouillage|Ncms|démouillage
démoulage|Ncms|démoulage
démultiplexage|Ncms|démultiplexage
dénûment|Ncms|dénûment
dénasalement|Ncms|dénasalement
dandinement|Ncms|dandinement
déneigement|Ncms|déneigement
dénervage|Ncms|dénervage
déniaisement|Ncms|déniaisement
dénichement|Ncms|dénichement
dénigrement|Ncms|dénigrement
dénivèlement|Ncms|dénivèlement
dénivellement|Ncms|dénivellement
dénoûment|Ncms|dénoûment
dénombrement|Ncms|dénombrement
dénouement|Ncms|dénouement
dénoyage|Ncms|dénoyage
dénoyautage|Ncms|dénoyautage
dénuement|Ncms|dénuement
dépècement|Ncms|dépècement
dépaillage|Ncms|dépaillage
dépaisselage|Ncms|dépaisselage
dépalissage|Ncms|dépalissage
dépannage|Ncms|dépannage
dépaperassement|Ncms|dépaperassement
dépaquetage|Ncms|dépaquetage
déparaffinage|Ncms|déparaffinage
déparagement|Ncms|déparagement
dépérissement|Ncms|dépérissement
déparquement|Ncms|déparquement
département|Ncms|département
dépassement|Ncms|dépassement
dépavage|Ncms|dépavage
dépaysement|Ncms|dépaysement
dépeçage|Ncms|dépeçage
dépenaillement|Ncms|dépenaillement
dépendage|Ncms|dépendage
dépeuplement|Ncms|dépeuplement
déphasage|Ncms|déphasage
dépiéçage|Ncms|dépiéçage
dépiècement|Ncms|dépiècement
dépicage|Ncms|dépicage
dépilage|Ncms|dépilage
dépilement|Ncms|dépilement
dépinglage|Ncms|dépinglage
dépiquage|Ncms|dépiquage
dépistage|Ncms|dépistage
déplacement|Ncms|déplacement
déplafonnement|Ncms|déplafonnement
déplantage|Ncms|déplantage
déplâtrage|Ncms|déplâtrage
dépliage|Ncms|dépliage
déplissage|Ncms|déplissage
déploiement|Ncms|déploiement
déplombage|Ncms|déplombage
dépointage|Ncms|dépointage
dépointement|Ncms|dépointement
dépolissage|Ncms|dépolissage
dépolissement|Ncms|dépolissement
dépontillage|Ncms|dépontillage
déportement|Ncms|déportement
dépotage|Ncms|dépotage
dépotement|Ncms|dépotement
dépouillage|Ncms|dépouillage
dépouillement|Ncms|dépouillement
dépourrissage|Ncms|dépourrissage
dépourrissement|Ncms|dépourrissement
dépoussiérage|Ncms|dépoussiérage
déprimage|Ncms|déprimage
déprisonnement|Ncms|déprisonnement
dépropriement|Ncms|dépropriement
dépucelage|Ncms|dépucelage
déracinement|Ncms|déracinement
déréférencement|Ncms|déréférencement
dérèglement|Ncms|dérèglement
dérailement|Ncms|dérailement
déraillement|Ncms|déraillement
déraisonnement|Ncms|déraisonnement
dérôlement|Ncms|dérôlement
déramage|Ncms|déramage
dérangement|Ncms|dérangement
dérapage|Ncms|dérapage
dérapement|Ncms|dérapement
dérasement|Ncms|dérasement
dardement|Ncms|dardement
déremboursement|Ncms|déremboursement
dariolage|Ncms|dariolage
dérivement|Ncms|dérivement
dérochage|Ncms|dérochage
dérochement|Ncms|dérochement
dérompage|Ncms|dérompage
dérouillage|Ncms|dérouillage
déroulement|Ncms|déroulement
déroutage|Ncms|déroutage
déroutement|Ncms|déroutement
désabonnement|Ncms|désabonnement
désabusement|Ncms|désabusement
désacclimatement|Ncms|désacclimatement
désaccouplement|Ncms|désaccouplement
désachalandage|Ncms|désachalandage
déséchouage|Ncms|déséchouage
désacidage|Ncms|désacidage
déséclusement|Ncms|déséclusement
désaffectionnement|Ncms|désaffectionnement
désaffleurement|Ncms|désaffleurement
désaffourchement|Ncms|désaffourchement
désagencement|Ncms|désagencement
désagrément|Ncms|désagrément
désajustement|Ncms|désajustement
désalignement|Ncms|désalignement
désallaitement|Ncms|désallaitement
désamarrage|Ncms|désamarrage
désamorçage|Ncms|désamorçage
désappareillage|Ncms|désappareillage
désappointement|Ncms|désappointement
désappropriement|Ncms|désappropriement
désapprouvement|Ncms|désapprouvement
désapprovisionnement|Ncms|désapprovisionnement
déséquençage|Ncms|déséquençage
désarêtage|Ncms|désarêtage
désarbrage|Ncms|désarbrage
désargentage|Ncms|désargentage
désarmement|Ncms|désarmement
désarrimage|Ncms|désarrimage
désassaisonnement|Ncms|désassaisonnement
désassemblage|Ncms|désassemblage
désassemblement|Ncms|désassemblement
désassiègement|Ncms|désassiègement
désétablissement|Ncms|désétablissement
désaubage|Ncms|désaubage
désœuvrement|Ncms|désœuvrement
désavantage|Ncms|désavantage
désaveuglement|Ncms|désaveuglement
désemballage|Ncms|désemballage
désembarquement|Ncms|désembarquement
désembellissement|Ncms|désembellissement
désemboîtement|Ncms|désemboîtement
désembouage|Ncms|désembouage
désembrayage|Ncms|désembrayage
désembrouillage|Ncms|désembrouillage
désembuage|Ncms|désembuage
désemparement|Ncms|désemparement
désempoisonnement|Ncms|désempoisonnement
désempoissonnement|Ncms|désempoissonnement
désencastage|Ncms|désencastage
désencerclement|Ncms|désencerclement
désenchantement|Ncms|désenchantement
désenclavement|Ncms|désenclavement
désencombrement|Ncms|désencombrement
désencroûtement|Ncms|désencroûtement
désendettement|Ncms|désendettement
désenflement|Ncms|désenflement
désenfumage|Ncms|désenfumage
désengagement|Ncms|désengagement
désengouement|Ncms|désengouement
désengrènement|Ncms|désengrènement
désenlacement|Ncms|désenlacement
désenrôlement|Ncms|désenrôlement
désenrayement|Ncms|désenrayement
désenrouement|Ncms|désenrouement
désensevelissement|Ncms|désensevelissement
désensorcellement|Ncms|désensorcellement
désentêtement|Ncms|désentêtement
désentassement|Ncms|désentassement
désentoilage|Ncms|désentoilage
déshabillage|Ncms|déshabillage
déshéritement|Ncms|déshéritement
désherbage|Ncms|désherbage
désheurement|Ncms|désheurement
désilage|Ncms|désilage
désimlockage|Ncms|désimlockage
désintéressement|Ncms|désintéressement
désinvestissement|Ncms|désinvestissement
désistement|Ncms|désistement
désorbitage|Ncms|désorbitage
désorcèlement|Ncms|désorcèlement
désorcellement|Ncms|désorcellement
désornage|Ncms|désornage
désossage|Ncms|désossage
désossement|Ncms|désossement
déstockage|Ncms|déstockage
désysopage|Ncms|désysopage
détachage|Ncms|détachage
détachement|Ncms|détachement
détagage|Ncms|détagage
datage|Ncms|datage
détalage|Ncms|détalage
détartrage|Ncms|détartrage
dételage|Ncms|dételage
déterrage|Ncms|déterrage
déterrement|Ncms|déterrement
détourage|Ncms|détourage
détournement|Ncms|détournement
détrônement|Ncms|détrônement
détraquement|Ncms|détraquement
détrichage|Ncms|détrichage
détricotage|Ncms|détricotage
détriment|Ncms|détriment
détritage|Ncms|détritage
détritiphage|Ncms|détritiphage
détrompage|Ncms|détrompage
détroquage|Ncms|détroquage
détroussement|Ncms|détroussement
dévêtissement|Ncms|dévêtissement
dévalisement|Ncms|dévalisement
dévasement|Ncms|dévasement
développement|Ncms|développement
déverdissage|Ncms|déverdissage
dévergondage|Ncms|dévergondage
dévergondement|Ncms|dévergondement
déverminage|Ncms|déverminage
dévernissage|Ncms|dévernissage
déverrouillage|Ncms|déverrouillage
déversement|Ncms|déversement
dévidage|Ncms|dévidage
dévirage|Ncms|dévirage
dévirolage|Ncms|dévirolage
dévirolement|Ncms|dévirolement
dévissage|Ncms|dévissage
dévissement|Ncms|dévissement
dévoûment|Ncms|dévoûment
dévoiement|Ncms|dévoiement
dévoilement|Ncms|dévoilement
dévoisement|Ncms|dévoisement
dévoltage|Ncms|dévoltage
dévorement|Ncms|dévorement
dévouement|Ncms|dévouement
dévrillage|Ncms|dévrillage
dézingage|Ncms|dézingage
dermophage|Ncms|dermophage
descellement|Ncms|descellement
dessèchement|Ncms|dessèchement
dessaisissement|Ncms|dessaisissement
dessaisonnement|Ncms|dessaisonnement
dessalage|Ncms|dessalage
dessalement|Ncms|dessalement
dessautement|Ncms|dessautement
desserrage|Ncms|desserrage
dessertissage|Ncms|dessertissage
dessillement|Ncms|dessillement
dessolement|Ncms|dessolement
dessouchement|Ncms|dessouchement
dessoufrage|Ncms|dessoufrage
dessuintage|Ncms|dessuintage
devancement|Ncms|devancement
devinement|Ncms|devinement
dimensionnement|Ncms|dimensionnement
discernement|Ncms|discernement
disciplinement|Ncms|disciplinement
disloquement|Ncms|disloquement
dissentiment|Ncms|dissentiment
divertissement|Ncms|divertissement
document|Ncms|document
dodelinement|Ncms|dodelinement
dodinage|Ncms|dodinage
dolage|Ncms|dolage
dommage|Ncms|dommage
domptage|Ncms|domptage
domptement|Ncms|domptement
dopage|Ncms|dopage
dorage|Ncms|dorage
dorlotement|Ncms|dorlotement
dosage|Ncms|dosage
dossage|Ncms|dossage
doublage|Ncms|doublage
doublement|Ncms|doublement
doucissage|Ncms|doucissage
douillage|Ncms|douillage
dragage|Ncms|dragage
drageonnage|Ncms|drageonnage
drageonnement|Ncms|drageonnement
drainage|Ncms|drainage
drapage|Ncms|drapage
drapement|Ncms|drapement
drayage|Ncms|drayage
dressage|Ncms|dressage
droguement|Ncms|droguement
droussage|Ncms|droussage
dudgeonnage|Ncms|dudgeonnage
duitage|Ncms|duitage
durcissement|Ncms|durcissement
durment|Ncms|durment
dynamitage|Ncms|dynamitage
dysfonctionnement|Ncms|dysfonctionnement
effaçage|Ncms|effaçage
effacement|Ncms|effacement
efféminement|Ncms|efféminement
effanage|Ncms|effanage
effarement|Ncms|effarement
effarouchement|Ncms|effarouchement
effautage|Ncms|effautage
effeuillage|Ncms|effeuillage
effeuillement|Ncms|effeuillement
effilage|Ncms|effilage
effilement|Ncms|effilement
effilochage|Ncms|effilochage
effleurage|Ncms|effleurage
effleurement|Ncms|effleurement
effondrement|Ncms|effondrement
effrènement|Ncms|effrènement
effritement|Ncms|effritement
embêtement|Ncms|embêtement
embûchement|Ncms|embûchement
emballage|Ncms|emballage
emballement|Ncms|emballement
embarbouillage|Ncms|embarbouillage
embarquement|Ncms|embarquement
embarrement|Ncms|embarrement
embasement|Ncms|embasement
embastillement|Ncms|embastillement
embatage|Ncms|embatage
embataillement|Ncms|embataillement
embattage|Ncms|embattage
embauchage|Ncms|embauchage
embauchement|Ncms|embauchement
embaumement|Ncms|embaumement
embellissement|Ncms|embellissement
emberlificotage|Ncms|emberlificotage
emblavage|Ncms|emblavage
emblavement|Ncms|emblavement
emboîtage|Ncms|emboîtage
emboîtement|Ncms|emboîtement
emboitage|Ncms|emboitage
emboitement|Ncms|emboitement
embossage|Ncms|embossage
embouchement|Ncms|embouchement
embouquement|Ncms|embouquement
embourbement|Ncms|embourbement
embourgeoisement|Ncms|embourgeoisement
embourrage|Ncms|embourrage
embourrement|Ncms|embourrement
emboursement|Ncms|emboursement
embouteillage|Ncms|embouteillage
embouteillement|Ncms|embouteillement
emboutissage|Ncms|emboutissage
embrêlage|Ncms|embrêlage
embrélage|Ncms|embrélage
embranchement|Ncms|embranchement
embrènement|Ncms|embrènement
embrasement|Ncms|embrasement
embrassement|Ncms|embrassement
embrèvement|Ncms|embrèvement
embrayage|Ncms|embrayage
embrelage|Ncms|embrelage
embrigadement|Ncms|embrigadement
embrochement|Ncms|embrochement
embroquement|Ncms|embroquement
embrouillage|Ncms|embrouillage
embrouillement|Ncms|embrouillement
emmêlage|Ncms|emmêlage
emmêlement|Ncms|emmêlement
emmagasinage|Ncms|emmagasinage
emmagasinement|Ncms|emmagasinement
emmaigrissement|Ncms|emmaigrissement
emmaillotement|Ncms|emmaillotement
emménagement|Ncms|emménagement
emmanchage|Ncms|emmanchage
emmanchement|Ncms|emmanchement
emmarchement|Ncms|emmarchement
emmassement|Ncms|emmassement
emmatelotage|Ncfs|emmatelotage
emmétrage|Ncms|emmétrage
emmerdement|Ncms|emmerdement
emmeulage|Ncms|emmeulage
emmiellement|Ncms|emmiellement
emmouchement|Ncms|emmouchement
emmouflement|Ncms|emmouflement
empêchement|Ncms|empêchement
empênage|Ncms|empênage
empagement|Ncms|empagement
empaillage|Ncms|empaillage
empaillement|Ncms|empaillement
empalement|Ncms|empalement
empalmage|Ncms|empalmage
empannage|Ncms|empannage
empansement|Ncms|empansement
empapaoutage|Ncms|empapaoutage
empaquetage|Ncms|empaquetage
emparadisement|Ncms|emparadisement
emparement|Ncms|emparement
empatage|Ncms|empatage
empâtage|Ncms|empâtage
empâtement|Ncms|empâtement
empattement|Ncms|empattement
empeignement|Ncms|empeignement
empellement|Ncms|empellement
empelotonnement|Ncms|empelotonnement
empennage|Ncms|empennage
empennelage|Ncms|empennelage
empesage|Ncms|empesage
empiècement|Ncms|empiècement
empiètement|Ncms|empiètement
empiétement|Ncms|empiétement
empierrage|Ncms|empierrage
empierrement|Ncms|empierrement
empilage|Ncms|empilage
empilement|Ncms|empilement
emplacement|Ncms|emplacement
emplage|Ncms|emplage
emplissage|Ncms|emplissage
empointage|Ncms|empointage
empoisonnement|Ncms|empoisonnement
empoissonnement|Ncms|empoissonnement
empommage|Ncms|empommage
emportement|Ncms|emportement
empotage|Ncms|empotage
empotement|Ncms|empotement
empoussiérage|Ncms|empoussiérage
empoussièrement|Ncms|empoussièrement
empoutage|Ncms|empoutage
empressement|Ncms|empressement
emprisonnement|Ncms|emprisonnement
empuantissement|Ncms|empuantissement
enarrhement|Ncms|enarrhement
encabanage|Ncms|encabanage
encabanement|Ncms|encabanement
encadrage|Ncms|encadrage
encadrement|Ncms|encadrement
encagement|Ncms|encagement
encaissage|Ncms|encaissage
encaissement|Ncms|encaissement
encalminage|Ncms|encalminage
encampanement|Ncms|encampanement
encanaillement|Ncms|encanaillement
encaquement|Ncms|encaquement
encartage|Ncms|encartage
encartonnage|Ncms|encartonnage
encartonnement|Ncms|encartonnement
encartouchage|Ncms|encartouchage
encasernement|Ncms|encasernement
encastage|Ncms|encastage
encastillage|Ncms|encastillage
encastrement|Ncms|encastrement
encaussement|Ncms|encaussement
encaustiquage|Ncms|encaustiquage
encavage|Ncms|encavage
encavement|Ncms|encavement
encellulement|Ncms|encellulement
encensement|Ncms|encensement
encerclement|Ncms|encerclement
enchaînement|Ncms|enchaînement
enchainement|Ncms|enchainement
enchalage|Ncms|enchalage
enchantelage|Ncms|enchantelage
enchantement|Ncms|enchantement
enchaperonnement|Ncms|enchaperonnement
enchérissement|Ncms|enchérissement
enchâssement|Ncms|enchâssement
enchatonnement|Ncms|enchatonnement
enchaussenage|Ncms|enchaussenage
enchemisage|Ncms|enchemisage
enchevêtrement|Ncms|enchevêtrement
enchevalement|Ncms|enchevalement
enchifrènement|Ncms|enchifrènement
encirement|Ncms|encirement
enclassement|Ncms|enclassement
enclavement|Ncms|enclavement
enclenchement|Ncms|enclenchement
encliquetage|Ncms|encliquetage
enclouage|Ncms|enclouage
encochement|Ncms|encochement
encodage|Ncms|encodage
encoffrement|Ncms|encoffrement
encollage|Ncms|encollage
encombrement|Ncms|encombrement
encorbellement|Ncms|encorbellement
encouragement|Ncms|encouragement
encrèchement|Ncms|encrèchement
encrage|Ncms|encrage
encrassement|Ncms|encrassement
encroûtement|Ncms|encroûtement
encroisement|Ncms|encroisement
encroutement|Ncms|encroutement
encryptage|Ncms|encryptage
enculage|Ncms|enculage
enculement|Ncms|enculement
encuvage|Ncms|encuvage
encuvement|Ncms|encuvement
endaubage|Ncms|endaubage
endettement|Ncms|endettement
endigage|Ncms|endigage
endiguement|Ncms|endiguement
endimanchement|Ncms|endimanchement
endoctrinement|Ncms|endoctrinement
endolorissement|Ncms|endolorissement
endommagement|Ncms|endommagement
endormement|Ncms|endormement
endormissement|Ncms|endormissement
endossage|Ncms|endossage
endossement|Ncms|endossement
endouzainement|Ncms|endouzainement
enduisage|Ncms|enduisage
endurcissement|Ncms|endurcissement
enfaçage|Ncms|enfaçage
enfaîtement|Ncms|enfaîtement
enfaitement|Ncms|enfaitement
enfantement|Ncms|enfantement
enfantillage|Ncms|enfantillage
enfarinage|Ncms|enfarinage
enfûtage|Ncms|enfûtage
enfermement|Ncms|enfermement
enfièvrement|Ncms|enfièvrement
enfilage|Ncms|enfilage
enflammement|Ncms|enflammement
enflement|Ncms|enflement
enfleurage|Ncms|enfleurage
enfoncement|Ncms|enfoncement
enfouissement|Ncms|enfouissement
enfourchement|Ncms|enfourchement
enfournage|Ncms|enfournage
enfournement|Ncms|enfournement
enfumage|Ncms|enfumage
enfutage|Ncms|enfutage
engagement|Ncms|engagement
engallage|Ncms|engallage
engazonnement|Ncms|engazonnement
engeignement|Ncms|engeignement
engendrement|Ncms|engendrement
engerbage|Ncms|engerbage
englacement|Ncms|englacement
engloutissement|Ncms|engloutissement
engluage|Ncms|engluage
engluement|Ncms|engluement
engoûment|Ncms|engoûment
engobage|Ncms|engobage
engommage|Ncms|engommage
engoncement|Ncms|engoncement
engorgement|Ncms|engorgement
engouement|Ncms|engouement
engouffrement|Ncms|engouffrement
engourdissement|Ncms|engourdissement
engrainage|Ncms|engrainage
engraissage|Ncms|engraissage
engraissement|Ncms|engraissement
engrènement|Ncms|engrènement
engrangement|Ncms|engrangement
engravement|Ncms|engravement
engrenage|Ncms|engrenage
enharnachement|Ncms|enharnachement
enivrement|Ncms|enivrement
enjaillement|Ncms|enjaillement
enjôlement|Ncms|enjôlement
enjambement|Ncms|enjambement
enjoûment|Ncms|enjoûment
enjolivement|Ncms|enjolivement
enjouement|Ncms|enjouement
enkikinement|Ncms|enkikinement
enkystement|Ncms|enkystement
enlacement|Ncms|enlacement
enlaidissement|Ncms|enlaidissement
enlèvement|Ncms|enlèvement
enlevage|Ncms|enlevage
enlignement|Ncms|enlignement
enlisement|Ncms|enlisement
enluminement|Ncms|enluminement
enneigement|Ncms|enneigement
ennillage|Ncms|ennillage
ennoblissement|Ncms|ennoblissement
ennoyage|Ncms|ennoyage
enquiquinement|Ncms|enquiquinement
enracinement|Ncms|enracinement
enragement|Ncms|enragement
enrégimentement|Ncms|enrégimentement
enraiement|Ncms|enraiement
enrôlement|Ncms|enrôlement
enrayage|Ncms|enrayage
enrayement|Ncms|enrayement
enregistrement|Ncms|enregistrement
enrichissement|Ncms|enrichissement
enrobage|Ncms|enrobage
enrobement|Ncms|enrobement
enrochement|Ncms|enrochement
enroidissement|Ncms|enroidissement
enrouement|Ncms|enrouement
enrouillement|Ncms|enrouillement
enroulage|Ncms|enroulage
enroulement|Ncms|enroulement
enruchage|Ncms|enruchage
ensablement|Ncms|ensablement
ensabotage|Ncms|ensabotage
ensabotement|Ncms|ensabotement
ensachage|Ncms|ensachage
ensachement|Ncms|ensachement
ensanglantement|Ncms|ensanglantement
ensauvagement|Ncms|ensauvagement
ensectionnement|Ncms|ensectionnement
enseignement|Ncms|enseignement
ensemencement|Ncms|ensemencement
enserrement|Ncms|enserrement
enseuillement|Ncms|enseuillement
ensevelissement|Ncms|ensevelissement
ensilage|Ncms|ensilage
ensilotage|Ncms|ensilotage
ensimage|Ncms|ensimage
ensoleillement|Ncms|ensoleillement
ensorcèlement|Ncms|ensorcèlement
ensorcellement|Ncms|ensorcellement
ensouillage|Ncms|ensouillage
ensoyement|Ncms|ensoyement
entêtement|Ncms|entêtement
entablement|Ncms|entablement
entaillage|Ncms|entaillage
entôlage|Ncms|entôlage
entamement|Ncms|entamement
entérinement|Ncms|entérinement
entartage|Ncms|entartage
entartement|Ncms|entartement
entartrage|Ncms|entartrage
entassement|Ncms|entassement
entement|Ncms|entement
entendement|Ncms|entendement
enterrage|Ncms|enterrage
enterrement|Ncms|enterrement
entichement|Ncms|entichement
entiercement|Ncms|entiercement
entoilage|Ncms|entoilage
entoisage|Ncms|entoisage
entomophage|Ncms|entomophage
entonnage|Ncms|entonnage
entonnement|Ncms|entonnement
entortillage|Ncms|entortillage
entortillement|Ncms|entortillement
entourage|Ncms|entourage
entraînement|Ncms|entraînement
entrage|Ncms|entrage
entrainement|Ncms|entrainement
entrebâillement|Ncms|entrebâillement
entrechoquement|Ncms|entrechoquement
entrecolonnement|Ncms|entrecolonnement
entrecoupement|Ncms|entrecoupement
entrecroisement|Ncms|entrecroisement
entrelacement|Ncms|entrelacement
entrelardement|Ncms|entrelardement
entremêlement|Ncms|entremêlement
entreposage|Ncms|entreposage
entubage|Ncms|entubage
envahissement|Ncms|envahissement
envalement|Ncms|envalement
envasement|Ncms|envasement
enveillotage|Ncms|enveillotage
enveloppement|Ncms|enveloppement
envenimement|Ncms|envenimement
envergement|Ncms|envergement
enverrage|Ncms|enverrage
envidage|Ncms|envidage
envieillissement|Ncms|envieillissement
environnement|Ncms|environnement
envoûtement|Ncms|envoûtement
envolement|Ncms|envolement
envoutement|Ncms|envoutement
envoyage|Ncms|envoyage
enzymage|Ncms|enzymage
ergotage|Ncms|ergotage
ermitage|Ncms|ermitage
errement|Ncms|errement
escamotage|Ncms|escamotage
escargassage|Ncms|escargassage
escargotage|Ncms|escargotage
escarpement|Ncms|escarpement
esclavage|Ncms|esclavage
espacement|Ncms|espacement
espadage|Ncms|espadage
espatage|Ncms|espatage
espionnage|Ncms|espionnage
espoulinage|Ncms|espoulinage
esquichage|Ncms|esquichage
esquimautage|Ncms|esquimautage
esquivelage|Ncms|esquivelage
esquivement|Ncms|esquivement
essaimage|Ncms|essaimage
essaimement|Ncms|essaimement
essangeage|Ncms|essangeage
essanvage|Ncms|essanvage
essartage|Ncms|essartage
essartement|Ncms|essartement
essayage|Ncms|essayage
esseiglage|Ncms|esseiglage
essorage|Ncms|essorage
essouchage|Ncms|essouchage
essouchement|Ncms|essouchement
essoufflement|Ncms|essoufflement
essuyage|Ncms|essuyage
establishment|Ncms|establishment
estampage|Ncms|estampage
estampillage|Ncms|estampillage
estivage|Ncms|estivage
estompage|Ncms|estompage
estropiement|Ncms|estropiement
europarlement|Ncms|europarlement
exaucement|Ncms|exaucement
excentrage|Ncms|excentrage
excitement|Ncms|excitement
excrément|Ncms|excrément
exhaussement|Ncms|exhaussement
exondement|Ncms|exondement
exténuement|Ncms|exténuement
exterminement|Ncms|exterminement
faïençage|Ncms|faïençage
façonnage|Ncms|façonnage
façonnement|Ncms|façonnement
faîtage|Ncms|faîtage
facettage|Ncms|facettage
factage|Ncms|factage
factorage|Ncms|factorage
fagotage|Ncms|fagotage
fagotement|Ncms|fagotement
faiblage|Ncms|faiblage
faiblissement|Ncms|faiblissement
faisandage|Ncms|faisandage
faitage|Ncms|faitage
falunage|Ncms|falunage
fanage|Ncms|fanage
fardage|Ncms|fardage
fardelage|Ncms|fardelage
farinage|Ncms|farinage
farotage|Ncms|farotage
fartage|Ncms|fartage
faséiement|Ncms|faséiement
fascinage|Ncms|fascinage
faucardage|Ncms|faucardage
fauchage|Ncms|fauchage
faudage|Ncms|faudage
fayotage|Ncms|fayotage
fenêtrage|Ncms|fenêtrage
fendage|Ncms|fendage
fendillement|Ncms|fendillement
ferlage|Ncms|ferlage
fermage|Ncms|fermage
ferment|Ncms|ferment
ferrage|Ncms|ferrage
ferraillage|Ncms|ferraillage
ferrement|Ncms|ferrement
ferroutage|Ncms|ferroutage
festonnement|Ncms|festonnement
feuillage|Ncms|feuillage
feuilletage|Ncms|feuilletage
feulement|Ncms|feulement
feutrage|Ncms|feutrage
feutrement|Ncms|feutrement
fibrociment|Ncms|fibrociment
ficelage|Ncms|ficelage
fichage|Ncms|fichage
fierliage|Ncms|fierliage
figeage|Ncms|figeage
figement|Ncms|figement
fignolage|Ncms|fignolage
filage|Ncms|filage
filament|Ncms|filament
filement|Ncms|filement
filetage|Ncms|filetage
filiforage|Ncms|filiforage
fillage|Ncms|fillage
filmage|Ncms|filmage
filoutage|Ncms|filoutage
filtrage|Ncms|filtrage
financement|Ncms|financement
firmament|Ncms|firmament
fixage|Ncms|fixage
fléchage|Ncms|fléchage
fléchissement|Ncms|fléchissement
flaconnage|Ncms|flaconnage
flageolement|Ncms|flageolement
flairage|Ncms|flairage
flairement|Ncms|flairement
flambage|Ncms|flambage
flambement|Ncms|flambement
flamboiement|Ncms|flamboiement
flanquement|Ncms|flanquement
flashage|Ncms|flashage
flattement|Ncms|flattement
flettage|Ncms|flettage
fleurage|Ncms|fleurage
fleurissement|Ncms|fleurissement
flicage|Ncms|flicage
flingage|Ncms|flingage
flirtage|Ncms|flirtage
flocage|Ncms|flocage
floconnement|Ncms|floconnement
flottage|Ncms|flottage
flottement|Ncms|flottement
floutage|Ncms|floutage
fluage|Ncms|fluage
fluotournage|Ncms|fluotournage
foage|Ncms|foage
foisonnement|Ncms|foisonnement
foliotage|Ncms|foliotage
folletage|Ncms|folletage
fonçage|Ncms|fonçage
foncement|Ncms|foncement
fonctionnement|Ncms|fonctionnement
fondement|Ncms|fondement
footage|Ncms|footage
forçage|Ncms|forçage
forage|Ncms|forage
forcènement|Ncms|forcènement
forcement|Ncms|forcement
forement|Ncms|forement
forestage|Ncms|forestage
foretage|Ncms|foretage
forgeage|Ncms|forgeage
forgement|Ncms|forgement
formage|Ncms|formage
formariage|Ncms|formariage
formatage|Ncms|formatage
fornage|Ncms|fornage
fortage|Ncms|fortage
fosserage|Ncms|fosserage
fossoiement|Ncms|fossoiement
fossoyage|Ncms|fossoyage
fouage|Ncms|fouage
foudroiement|Ncms|foudroiement
fouettage|Ncms|fouettage
fouettement|Ncms|fouettement
fouillement|Ncms|fouillement
fouissement|Ncms|fouissement
foulage|Ncms|foulage
foulement|Ncms|foulement
fourbaudage|Ncms|fourbaudage
fourbissage|Ncms|fourbissage
fourbissement|Ncms|fourbissement
fourmillement|Ncms|fourmillement
fournage|Ncms|fournage
fourniment|Ncms|fourniment
fournissement|Ncms|fournissement
fourragement|Ncms|fourragement
fourrage|Ncms|fourrage
fourvoiement|Ncms|fourvoiement
foutage|Ncms|foutage
fractionnement|Ncms|fractionnement
fragment|Ncms|fragment
fraisage|Ncms|fraisage
fraisement|Ncms|fraisement
frôlement|Ncms|frôlement
framboisement|Ncms|framboisement
frémissement|Ncms|frémissement
franchisage|Ncms|franchisage
franchissement|Ncms|franchissement
frappage|Ncms|frappage
frappement|Ncms|frappement
frasage|Ncms|frasage
frètement|Ncms|frètement
frétillage|Ncms|frétillage
frétillement|Ncms|frétillement
frayement|Ncms|frayement
fredonnement|Ncms|fredonnement
freinage|Ncms|freinage
frelatage|Ncms|frelatage
frelatement|Ncms|frelatement
frettage|Ncms|frettage
fricotage|Ncms|fricotage
frissonnement|Ncms|frissonnement
frittage|Ncms|frittage
froissage|Ncms|froissage
froissartage|Ncms|froissartage
froissement|Ncms|froissement
fromage|Ncms|fromage
froment|Ncms|froment
froncement|Ncms|froncement
frottage|Ncms|frottage
frottement|Ncms|frottement
frouement|Ncms|frouement
froufroutement|Ncms|froufroutement
fuitage|Ncms|fuitage
fumage|Ncms|fumage
furetage|Ncms|furetage
fuselage|Ncms|fuselage
fusement|Ncms|fusement
fusillement|Ncms|fusillement
fusionnement|Ncms|fusionnement
gabariage|Ncms|gabariage
gabattage|Ncms|gabattage
gabelage|Ncms|gabelage
gabiage|Ncms|gabiage
gabionnage|Ncms|gabionnage
gâchage|Ncms|gâchage
gadage|Ncms|gadage
gage|Ncms|gage
gagnage|Ncms|gagnage
gainage|Ncms|gainage
galandage|Ncms|galandage
galvaudage|Ncms|galvaudage
gamahuchage|Ncms|gamahuchage
gémissement|Ncms|gémissement
génotypage|Ncms|génotypage
géophage|Ncfs|géophage
géophage|Ncms|géophage
géoréférencement|Ncms|géoréférencement
garage|Ncms|garage
gardiennage|Ncms|gardiennage
gargotage|Ncms|gargotage
gargouillement|Ncms|gargouillement
garlandage|Ncms|garlandage
garnement|Ncms|garnement
garnissage|Ncms|garnissage
garrochage|Ncms|garrochage
garrotage|Ncms|garrotage
garrottage|Ncms|garrottage
gaspillage|Ncms|gaspillage
gauchissage|Ncms|gauchissage
gauchissement|Ncms|gauchissement
gaudage|Ncms|gaudage
gaufrage|Ncms|gaufrage
gaulage|Ncms|gaulage
gavage|Ncms|gavage
gazage|Ncms|gazage
gazonnage|Ncms|gazonnage
gazonnement|Ncms|gazonnement
gazouillement|Ncms|gazouillement
geôlage|Ncms|geôlage
geignement|Ncms|geignement
gelinage|Ncms|gelinage
gemmage|Ncms|gemmage
gerbage|Ncms|gerbage
gercement|Ncms|gercement
giclement|Ncms|giclement
gillotage|Ncms|gillotage
gisement|Ncms|gisement
gitage|Ncms|gitage
givrage|Ncms|givrage
glaçage|Ncms|glaçage
glage|Ncms|glage
glairage|Ncms|glairage
glanage|Ncms|glanage
glandage|Ncms|glandage
glapissement|Ncms|glapissement
glissage|Ncms|glissage
glissement|Ncms|glissement
glorifiement|Ncms|glorifiement
glougloutement|Ncms|glougloutement
gloussement|Ncms|gloussement
gnassage|Ncms|gnassage
gobelotage|Ncms|gobelotage
gobetage|Ncms|gobetage
godage|Ncms|godage
godronnage|Ncms|godronnage
gommage|Ncms|gommage
gommement|Ncms|gommement
gondolage|Ncms|gondolage
gonflage|Ncms|gonflage
gonflement|Ncms|gonflement
goudronnage|Ncms|goudronnage
goupillonnage|Ncms|goupillonnage
gourbillage|Ncms|gourbillage
gourdoyement|Ncms|gourdoyement
gouvernement|Ncms|gouvernement
gréage|Ncms|gréage
grabelage|Ncms|grabelage
gréement|Ncms|gréement
grage|Ncfs|grage
graillement|Ncms|graillement
grainage|Ncms|grainage
graissage|Ncms|graissage
grammage|Ncms|grammage
grangeage|Ncms|grangeage
granulage|Ncms|granulage
grappillage|Ncms|grappillage
grésage|Ncms|grésage
grésillement|Ncms|grésillement
grasseyement|Ncms|grasseyement
grattage|Ncms|grattage
grattouillage|Ncms|grattouillage
gravage|Ncms|gravage
grecquage|Ncms|grecquage
greffage|Ncms|greffage
grelotement|Ncms|grelotement
grelottement|Ncms|grelottement
grelouage|Ncms|grelouage
grenage|Ncms|grenage
grenaillage|Ncms|grenaillage
grenaillement|Ncms|grenaillement
grenouillage|Ncms|grenouillage
greylistage|Ncms|greylistage
gribouillage|Ncms|gribouillage
griffage|Ncms|griffage
griffonnage|Ncms|griffonnage
griffonnement|Ncms|griffonnement
grignage|Ncms|grignage
grignotage|Ncms|grignotage
grignotement|Ncms|grignotement
grillage|Ncms|grillage
grimage|Ncms|grimage
grimaudage|Ncms|grimaudage
grimelinage|Ncms|grimelinage
grincement|Ncms|grincement
grippage|Ncms|grippage
grisage|Ncms|grisage
grisâtrement|Ncms|grisâtrement
grognement|Ncms|grognement
grommèlement|Ncms|grommèlement
grommellement|Ncms|grommellement
grondement|Ncms|grondement
grossissement|Ncms|grossissement
grouillement|Ncms|grouillement
grouinement|Ncms|grouinement
groupage|Ncms|groupage
groupement|Ncms|groupement
guéage|Ncms|guéage
guêtrage|Ncms|guêtrage
gueulement|Ncms|gueulement
guidage|Ncms|guidage
guidonnage|Ncms|guidonnage
guillage|Ncms|guillage
guillochage|Ncms|guillochage
guillotinement|Ncms|guillotinement
guindage|Ncms|guindage
hébètement|Ncms|hébètement
hébétement|Ncms|hébétement
hébergeage|Ncms|hébergeage
hébergement|Ncms|hébergement
habillage|Ncms|habillage
habillement|Ncms|habillement
hachage|Ncms|hachage
hachement|Ncms|hachement
halage|Ncms|halage
halètement|Ncms|halètement
halement|Ncms|halement
hôlement|Ncms|hôlement
héliportage|Ncms|héliportage
hélitreuillage|Ncms|hélitreuillage
hallage|Ncms|hallage
hallebotage|Ncms|hallebotage
hameçonnage|Ncms|hameçonnage
hanchement|Ncms|hanchement
handiplage|Ncfs|handiplage
hannetonnage|Ncms|hannetonnage
hantement|Ncms|hantement
happement|Ncms|happement
harassement|Ncms|harassement
harcèlement|Ncms|harcèlement
harcelage|Ncms|harcelage
hargotage|Ncms|hargotage
hérissement|Ncms|hérissement
hérissonnement|Ncms|hérissonnement
héritage|Ncms|héritage
harnachement|Ncms|harnachement
harpage|Ncms|harpage
harponnage|Ncms|harponnage
harponnement|Ncms|harponnement
haubanage|Ncms|haubanage
haussement|Ncms|haussement
havage|Ncms|havage
hennissement|Ncms|hennissement
herbage|Ncms|herbage
herchage|Ncms|herchage
hersage|Ncms|hersage
herschage|Ncms|herschage
hersement|Ncms|hersement
heurtement|Ncms|heurtement
hibernage|Ncms|hibernage
hiement|Ncms|hiement
hippophage|Ncfs|hippophage
hippophage|Ncms|hippophage
histasapage|Ncms|histasapage
histrionage|Ncms|histrionage
hivernage|Ncms|hivernage
hivernement|Ncms|hivernement
hochement|Ncms|hochement
holement|Ncms|holement
hommage|Ncms|hommage
honage|Ncms|honage
hongroyage|Ncms|hongroyage
honnissement|Ncms|honnissement
horodatage|Ncms|horodatage
hortillonnage|Ncms|hortillonnage
houage|Ncms|houage
houblonnage|Ncms|houblonnage
houement|Ncms|houement
houhoulement|Ncms|houhoulement
houillage|Ncms|houillage
houpement|Ncms|houpement
hourdage|Ncms|hourdage
houssage|Ncms|houssage
huage|Ncms|huage
huilage|Ncms|huilage
huilement|Ncms|huilement
hululement|Ncms|hululement
humage|Ncms|humage
humectage|Ncms|humectage
hurlement|Ncms|hurlement
hydrocraquage|Ncms|hydrocraquage
hydroensemencement|Ncms|hydroensemencement
hydrogommage|Ncms|hydrogommage
hydromassage|Ncms|hydromassage
hydroplanage|Ncms|hydroplanage
hydrotraitement|Ncms|hydrotraitement
hypallage|Ncfs|hypallage
ichtyophage|Ncfs|ichtyophage
ichtyophage|Ncms|ichtyophage
image|Ncfs|image
impaiement|Ncms|impaiement
impayement|Ncms|impayement
imprimage|Ncms|imprimage
inacclimatement|Ncms|inacclimatement
inaccomplissement|Ncmp|inaccomplissement
inachèvement|Ncms|inachèvement
inalpage|Ncms|inalpage
inapaisement|Ncms|inapaisement
inassouvissement|Ncms|inassouvissement
incrément|Ncms|incrément
indigitament|Ncms|indigitament
indiscernement|Ncms|indiscernement
inertage|Ncms|inertage
infléchissement|Ncms|infléchissement
infodivertissement|Ncms|infodivertissement
infotainment|Ncfs|infotainment
infotainment|Ncms|infotainment
inhibage|Ncms|inhibage
insinuement|Ncms|insinuement
instrument|Ncms|instrument
intéressement|Ncms|intéressement
interblocage|Ncms|interblocage
interfaçage|Ncms|interfaçage
interfoliage|Ncms|interfoliage
interlettrage|Ncms|interlettrage
interlignage|Ncms|interlignage
intermariage|Ncms|intermariage
internement|Ncms|internement
intervertissement|Ncms|intervertissement
investissement|Ncms|investissement
invitement|Ncms|invitement
irisage|Ncms|irisage
ischiopage|Ncms|ischiopage
isolement|Ncms|isolement
jabotage|Ncms|jabotage
jacassement|Ncms|jacassement
jaillissement|Ncms|jaillissement
jalage|Ncms|jalage
jalonnement|Ncms|jalonnement
jambage|Ncms|jambage
jappage|Ncms|jappage
jappement|Ncms|jappement
jardinage|Ncms|jardinage
jasement|Ncms|jasement
jaspage|Ncms|jaspage
jaugeage|Ncms|jaugeage
jaunissage|Ncms|jaunissage
jaunissement|Ncms|jaunissement
javelage|Ncms|javelage
jetage|Ncms|jetage
jointement|Ncms|jointement
jointoiement|Ncms|jointoiement
jonchement|Ncms|jonchement
jonglage|Ncms|jonglage
jugement|Ncms|jugement
jumelage|Ncms|jumelage
jument|Ncfs|jument
jurement|Ncms|jurement
kidnappage|Ncms|kidnappage
kilométrage|Ncms|kilométrage
kilotage|Ncms|kilotage
klaxonnement|Ncms|klaxonnement
laçage|Ncms|laçage
labferment|Ncms|labferment
labourage|Ncms|labourage
lacement|Ncms|lacement
lâchage|Ncms|lâchage
léchage|Ncms|léchage
lèchement|Ncms|lèchement
lainage|Ncms|lainage
laitage|Ncms|laitage
laitonnage|Ncms|laitonnage
lamage|Ncms|lamage
lamanage|Ncms|lamanage
lambrissage|Ncms|lambrissage
lambrissement|Ncms|lambrissement
laminage|Ncms|laminage
lançage|Ncms|lançage
lancement|Ncms|lancement
lancinement|Ncms|lancinement
landage|Ncms|landage
langage|Ncms|langage
langueyage|Ncms|langueyage
languissement|Ncms|languissement
lantiponnage|Ncms|lantiponnage
lapement|Ncms|lapement
lapidement|Ncms|lapidement
laquage|Ncms|laquage
lardonnement|Ncms|lardonnement
largage|Ncms|largage
larguage|Ncms|larguage
larmoiement|Ncms|larmoiement
larmoyage|Ncms|larmoyage
lattage|Ncms|lattage
lavage|Ncms|lavage
lèvement|Ncms|lèvement
lavement|Ncms|lavement
layage|Ncms|layage
lessivage|Ncms|lessivage
lestage|Ncms|lestage
lettrage|Ncms|lettrage
levage|Ncms|levage
liage|Ncms|liage
libage|Ncms|libage
libertinage|Ncms|libertinage
librament|Ncms|librament
licenciement|Ncms|licenciement
liement|Ncms|liement
ligament|Ncms|ligament
lignage|Ncms|lignage
ligotage|Ncfs|ligotage
limage|Ncms|limage
limogeage|Ncms|limogeage
limonage|Ncms|limonage
limosinage|Ncms|limosinage
limousinage|Ncms|limousinage
linéament|Ncms|linéament
lipomodelage|Ncms|lipomodelage
lisage|Ncms|lisage
lisérage|Ncms|lisérage
liserage|Ncms|liserage
lissage|Ncms|lissage
listage|Ncms|listage
litage|Ncms|litage
lithophage|Ncms|lithophage
livrage|Ncms|livrage
lochage|Ncms|lochage
logement|Ncms|logement
logotage|Ncms|logotage
lombricompostage|Ncms|lombricompostage
lorgnement|Ncms|lorgnement
lotionnement|Ncms|lotionnement
lotissage|Ncms|lotissage
lotissement|Ncms|lotissement
louage|Ncms|louage
louchement|Ncms|louchement
louvage|Ncms|louvage
louvetage|Ncms|louvetage
louvoiement|Ncms|louvoiement
louvoyage|Ncms|louvoyage
luchage|Ncms|luchage
lunement|Ncms|lunement
lustrage|Ncms|lustrage
lutage|Ncms|lutage
lutinage|Ncms|lutinage
lynchage|Ncms|lynchage
mêlement|Ncms|mêlement
maçonnage|Ncms|maçonnage
macadamisage|Ncms|macadamisage
méchage|Ncms|méchage
mâchement|Ncms|mâchement
machicotage|Ncms|machicotage
mâchonnage|Ncms|mâchonnage
mâchonnement|Ncms|mâchonnement
maclage|Ncms|maclage
mécontentement|Ncms|mécontentement
macquage|Ncms|macquage
macroélément|Ncms|macroélément
macrolangage|Ncms|macrolangage
macrophage|Ncms|macrophage
maculage|Ncms|maculage
médicaliment|Ncms|médicaliment
médicament|Ncms|médicament
magasinage|Ncms|magasinage
mage|Ncms|mage
magouillage|Ncms|magouillage
maillage|Ncms|maillage
mailletage|Ncms|mailletage
maisonnage|Ncms|maisonnage
méjanage|Ncms|méjanage
mélage|Ncms|mélage
malaxage|Ncms|malaxage
méliphage|Ncms|méliphage
mélophage|Ncms|mélophage
maltage|Ncms|maltage
maltraitement|Ncms|maltraitement
manéage|Ncms|manéage
ménagement|Ncmp|ménagement
management|Ncms|management
ménage|Ncms|ménage
mandatement|Ncms|mandatement
mandement|Ncms|mandement
maniage|Ncms|maniage
maniement|Ncms|maniement
manillage|Ncms|manillage
mannequinage|Ncms|mannequinage
manocage|Ncms|manocage
manquement|Ncms|manquement
manuportage|Ncms|manuportage
mappage|Ncms|mappage
maquerellage|Ncms|maquerellage
maquignage|Ncms|maquignage
maquignonnage|Ncms|maquignonnage
maquillage|Ncms|maquillage
maraîchage|Ncms|maraîchage
maraîchinage|Ncms|maraîchinage
maréage|Ncms|maréage
maraboutage|Ncms|maraboutage
marécage|Ncms|marécage
maraichage|Ncms|maraichage
maraudage|Ncms|maraudage
marchéage|Ncms|marchéage
marchage|Ncms|marchage
marchandage|Ncms|marchandage
marchandisage|Ncms|marchandisage
marcottage|Ncms|marcottage
mareyage|Ncms|mareyage
margeage|Ncms|margeage
marguillage|Ncms|marguillage
mariage|Ncms|mariage
marinage|Ncms|marinage
mûrissage|Ncms|mûrissage
mûrissement|Ncms|mûrissement
marivaudage|Ncms|marivaudage
marmitage|Ncms|marmitage
marmonnement|Ncms|marmonnement
marmottage|Ncms|marmottage
marmottement|Ncms|marmottement
marnage|Ncms|marnage
maroquinage|Ncms|maroquinage
marouflage|Ncms|marouflage
marquage|Ncms|marquage
marronnage|Ncms|marronnage
marsage|Ncms|marsage
marsouinage|Ncms|marsouinage
martèlement|Ncms|martèlement
martelage|Ncms|martelage
martellement|Ncms|martellement
masage|Ncms|masage
mésappariement|Ncms|mésappariement
masquage|Ncms|masquage
massage|Ncms|massage
massement|Ncms|massement
masticage|Ncms|masticage
mésusage|Ncms|mésusage
matage|Ncms|matage
mâtage|Ncms|mâtage
métalangage|Ncms|métalangage
métallisage|Ncms|métallisage
métayage|Ncms|métayage
matelassage|Ncms|matelassage
matelotage|Ncms|matelotage
maternage|Ncms|maternage
métissage|Ncms|métissage
métrage|Ncms|métrage
matraquage|Ncms|matraquage
matriçage|Ncms|matriçage
matrissage|Ncms|matrissage
mazéage|Ncms|mazéage
menage|Ncms|menage
menottage|Ncms|menottage
message|Ncms|message
mesurage|Ncms|mesurage
meuglement|Ncms|meuglement
meulage|Ncms|meulage
miaulement|Ncms|miaulement
microélément|Ncms|microélément
microfinancement|Ncms|microfinancement
micropaiement|Ncms|micropaiement
millage|Ncms|millage
millerandage|Ncms|millerandage
minage|Ncms|minage
minimessage|Ncms|minimessage
miniphage|Ncms|miniphage
minutage|Ncms|minutage
mirage|Ncms|mirage
miroitage|Ncms|miroitage
miroitement|Ncms|miroitement
mitadinage|Ncms|mitadinage
mitage|Ncms|mitage
mitonnage|Ncms|mitonnage
mitraillage|Ncms|mitraillage
mixage|Ncms|mixage
modelage|Ncms|modelage
moirage|Ncms|moirage
moissonnage|Ncms|moissonnage
moletage|Ncms|moletage
molettage|Ncms|molettage
moment|Ncms|moment
mondage|Ncms|mondage
monitorage|Ncms|monitorage
monnayage|Ncms|monnayage
montage|Ncms|montage
monument|Ncms|monument
morcèlement|Ncms|morcèlement
morcellement|Ncms|morcellement
mordançage|Ncms|mordançage
mordillage|Ncms|mordillage
morfilage|Ncms|morfilage
mortaisage|Ncms|mortaisage
mosaïquage|Ncms|mosaïquage
mouchage|Ncms|mouchage
mouchardage|Ncms|mouchardage
mouflage|Ncms|mouflage
mouillage|Ncms|mouillage
mouillement|Ncms|mouillement
moulage|Ncms|moulage
moulinage|Ncms|moulinage
moussage|Ncms|moussage
moutonnement|Ncms|moutonnement
mouvage|Ncms|mouvage
mouvement|Ncms|mouvement
moyennage|Ncms|moyennage
mucilage|Ncms|mucilage
mugissement|Ncms|mugissement
mulotage|Ncmp|mulotage
mulotage|Ncms|mulotage
multiplexage|Ncms|multiplexage
multipostage|Ncms|multipostage
multitraitement|Ncms|multitraitement
murage|Ncms|murage
murissage|Ncms|murissage
murissement|Ncms|murissement
musèlement|Ncms|musèlement
museletage|Ncms|museletage
musellement|Ncms|musellement
musophage|Ncms|musophage
mutage|Ncms|mutage
mutinement|Ncms|mutinement
myrmécophage|Ncms|myrmécophage
nécrophage|Ncms|nécrophage
nagement|Ncms|nagement
nage|Ncfs|nage
naissage|Ncms|naissage
nantissement|Ncms|nantissement
nappage|Ncms|nappage
nasillement|Ncms|nasillement
nasillonnement|Ncms|nasillonnement
nasonnement|Ncms|nasonnement
nattage|Ncms|nattage
naufrage|Ncms|naufrage
naulage|Ncms|naulage
navettage|Ncms|navettage
nectariphage|Ncms|nectariphage
nettoiement|Ncms|nettoiement
nettoyage|Ncms|nettoyage
neuvage|Ncms|neuvage
nickelage|Ncms|nickelage
nickelisage|Ncms|nickelisage
niellage|Ncms|niellage
niquetage|Ncms|niquetage
nivèlement|Ncms|nivèlement
nivelage|Ncms|nivelage
nivellement|Ncms|nivellement
noircissement|Ncms|noircissement
nolisage|Ncms|nolisage
nolisement|Ncms|nolisement
nolissement|Ncms|nolissement
nommage|Ncms|nommage
nopage|Ncms|nopage
notage|Ncms|notage
nouage|Ncms|nouage
nouement|Ncms|nouement
nourrissage|Ncms|nourrissage
nourrissement|Ncms|nourrissement
noyautage|Ncms|noyautage
nuage|Ncms|nuage
nuancement|Ncms|nuancement
numérotage|Ncms|numérotage
nutriment|Ncms|nutriment
obscurcissement|Ncms|obscurcissement
octroiement|Ncms|octroiement
offusquement|Ncms|offusquement
oligoélément|Ncms|oligoélément
olivage|Ncms|olivage
ombrage|Ncms|ombrage
omophage|Ncfs|omophage
omophage|Ncms|omophage
ondoiement|Ncms|ondoiement
opalage|Ncms|opalage
ophiophage|Ncms|ophiophage
optoguidage|Ncms|optoguidage
orage|Ncms|orage
ordonnancement|Ncms|ordonnancement
orgage|Ncms|orgage
organsinage|Ncms|organsinage
orientement|Ncms|orientement
ornement|Ncms|ornement
ornithophage|Ncms|ornithophage
orpaillage|Ncms|orpaillage
orpiment|Ncms|orpiment
ortiage|Ncms|ortiage
osage|Ncms|osage
ossement|Ncms|ossement
otage|Ncfs|otage
otage|Ncms|otage
ouillage|Ncms|ouillage
ourdissage|Ncms|ourdissage
outillage|Ncms|outillage
outplacement|Ncms|outplacement
outragement|Ncms|outragement
outrage|Ncms|outrage
ouvrage|Ncms|ouvrage
oxycoupage|Ncms|oxycoupage
péage|Ncms|péage
pacage|Ncms|pacage
package|Ncms|package
pacquage|Ncms|pacquage
pacsage|Ncms|pacsage
pédalage|Ncms|pédalage
page|Ncfs|page
page|Ncms|page
pagophage|Ncfs|pagophage
pagophage|Ncms|pagophage
paiement|Ncms|paiement
paillage|Ncms|paillage
paillassonnage|Ncms|paillassonnage
paillement|Ncms|paillement
pairage|Ncms|pairage
paisselage|Ncms|paisselage
paléage|Ncms|paléage
paladinage|Ncms|paladinage
paléoenvironnement|Ncms|paléoenvironnement
pèlerinage|Ncms|pèlerinage
pélerinage|Ncms|pélerinage
palissage|Ncms|palissage
palotage|Ncms|palotage
panachage|Ncms|panachage
panage|Ncms|panage
pancartage|Ncms|pancartage
panneautage|Ncms|panneautage
pansage|Ncms|pansage
pansement|Ncms|pansement
pantellement|Ncms|pantellement
pantoiement|Ncms|pantoiement
pantouflage|Ncms|pantouflage
péonage|Ncms|péonage
pépiage|Ncms|pépiage
pépiement|Ncms|pépiement
papillonnage|Ncms|papillonnage
papillonnement|Ncms|papillonnement
papillotage|Ncms|papillotage
papillotement|Ncms|papillotement
papotage|Ncms|papotage
paquage|Ncms|paquage
paquetage|Ncms|paquetage
paréage|Ncms|paréage
parachèvement|Ncms|parachèvement
parachutage|Ncms|parachutage
paraffinage|Ncms|paraffinage
parage|Ncms|parage
péréguement|Ncms|péréguement
paralangage|Ncms|paralangage
paramétrage|Ncms|paramétrage
parangonnage|Ncms|parangonnage
parcage|Ncms|parcage
parcellement|Ncms|parcellement
parement|Ncms|parement
parentage|Ncms|parentage
parfilage|Ncms|parfilage
pariage|Ncms|pariage
périssement|Ncms|périssement
parlage|Ncms|parlage
parlementage|Ncms|parlementage
parlement|Ncms|parlement
parquement|Ncms|parquement
parquetage|Ncms|parquetage
parrainage|Ncms|parrainage
partage|Ncms|partage
partènement|Ncms|partènement
pèsement|Ncms|pèsement
passage|Ncms|passage
passefilage|Ncms|passefilage
passement|Ncms|passement
passerage|Ncfs|passerage
passerillage|Ncms|passerillage
pastillage|Ncms|pastillage
pétage|Ncms|pétage
pétardement|Ncms|pétardement
pataugeage|Ncms|pataugeage
patchage|Ncms|patchage
patelinage|Ncms|patelinage
patentage|Ncms|patentage
pétillement|Ncms|pétillement
pâtiment|Ncms|pâtiment
patinage|Ncms|patinage
pâtissage|Ncms|pâtissage
pétitionnement|Ncms|pétitionnement
patouillement|Ncms|patouillement
patricotage|Ncms|patricotage
pétrissage|Ncms|pétrissage
patronage|Ncms|patronage
patrouillage|Ncms|patrouillage
pattinsonage|Ncms|pattinsonage
pâturage|Ncms|pâturage
pavage|Ncms|pavage
pavanement|Ncms|pavanement
pavement|Ncms|pavement
pavoisement|Ncms|pavoisement
paysage|Ncms|paysage
peaufinage|Ncms|peaufinage
peignage|Ncms|peignage
peinturlurage|Ncms|peinturlurage
pelage|Ncms|pelage
pelletage|Ncms|pelletage
pelleversage|Ncms|pelleversage
pelliculage|Ncms|pelliculage
pelotage|Ncms|pelotage
pelotonnement|Ncms|pelotonnement
penchement|Ncms|penchement
pendage|Ncms|pendage
pennage|Ncms|pennage
perçage|Ncms|perçage
percement|Ncms|percement
perchage|Ncms|perchage
perfectionnement|Ncms|perfectionnement
perforage|Ncms|perforage
perpignage|Ncms|perpignage
persiflage|Ncms|persiflage
personnage|Ncms|personnage
pervertissement|Ncms|pervertissement
pervibrage|Ncms|pervibrage
pesage|Ncms|pesage
peuplement|Ncms|peuplement
phage|Ncms|phage
phosphatage|Ncms|phosphatage
photoblanchiment|Ncms|photoblanchiment
photocopillage|Ncms|photocopillage
photomontage|Ncms|photomontage
photoreportage|Ncms|photoreportage
phytophage|Ncms|phytophage
piaffement|Ncms|piaffement
piégeage|Ncms|piégeage
piaillement|Ncms|piaillement
pianotage|Ncms|pianotage
piètement|Ncms|piètement
piétement|Ncms|piétement
piétinement|Ncms|piétinement
piaulement|Ncms|piaulement
picage|Ncms|picage
picaillonnage|Ncms|picaillonnage
picochage|Ncms|picochage
picolage|Ncms|picolage
picorage|Ncms|picorage
picotage|Ncms|picotage
picotement|Ncms|picotement
pigeage|Ncms|pigeage
pigment|Ncms|pigment
pignochage|Ncms|pignochage
pilage|Ncms|pilage
pillage|Ncms|pillage
pillement|Ncms|pillement
pilonnage|Ncms|pilonnage
piloriement|Ncms|piloriement
pilotage|Ncms|pilotage
piment|Ncms|piment
pinçage|Ncms|pinçage
pinaillage|Ncms|pinaillage
pinceautage|Ncms|pinceautage
pincement|Ncms|pincement
piochage|Ncms|piochage
pionnage|Ncms|pionnage
pipeautage|Ncms|pipeautage
pipelinage|Ncms|pipelinage
pipiement|Ncms|pipiement
pipotage|Ncms|pipotage
piquage|Ncms|piquage
piquetage|Ncms|piquetage
piratage|Ncms|piratage
pissement|Ncms|pissement
pistage|Ncms|pistage
pistonnage|Ncms|pistonnage
pitonnage|Ncms|pitonnage
pituitement|Ncms|pituitement
pivotage|Ncms|pivotage
pivotement|Ncms|pivotement
plaçage|Ncms|plaçage
placage|Ncms|placage
placardage|Ncms|placardage
placement|Ncms|placement
placotage|Ncms|placotage
plafonnage|Ncms|plafonnage
plafonnement|Ncms|plafonnement
plage|Ncfs|plage
plainage|Ncms|plainage
plamotage|Ncms|plamotage
planage|Ncms|planage
planchage|Ncms|planchage
planchéiage|Ncms|planchéiage
planement|Ncms|planement
plantage|Ncms|plantage
plantement|Ncms|plantement
plaquage|Ncms|plaquage
plasticage|Ncms|plasticage
plastiquage|Ncms|plastiquage
platelage|Ncms|platelage
platinage|Ncms|platinage
plâtrage|Ncms|plâtrage
plessage|Ncms|plessage
pleurage|Ncms|pleurage
pleurement|Ncms|pleurement
pleurnichage|Ncms|pleurnichage
pleurnichement|Ncms|pleurnichement
pliage|Ncms|pliage
pliement|Ncms|pliement
plionnage|Ncms|plionnage
plissage|Ncms|plissage
plissement|Ncms|plissement
plocage|Ncms|plocage
ploiement|Ncms|ploiement
plombage|Ncms|plombage
plumage|Ncms|plumage
plumotage|Ncms|plumotage
plusage|Ncms|plusage
pluviolessivage|Ncms|pluviolessivage
pochage|Ncms|pochage
poinçonnage|Ncms|poinçonnage
poinçonnement|Ncms|poinçonnement
pointage|Ncms|pointage
pointillage|Ncms|pointillage
poireautage|Ncms|poireautage
poissement|Ncms|poissement
policement|Ncms|policement
polissage|Ncms|polissage
pollupostage|Ncms|pollupostage
polypage|Ncms|polypage
polyphage|Ncfs|polyphage
polyphage|Ncms|polyphage
pommerage|Ncfs|pommerage
pompage|Ncms|pompage
ponçage|Ncms|ponçage
ponctuage|Ncms|ponctuage
pontage|Ncms|pontage
pontonage|Ncms|pontonage
pontonnage|Ncms|pontonnage
populage|Ncms|populage
portement|Ncms|portement
posage|Ncms|posage
positionnement|Ncms|positionnement
postage|Ncms|postage
potage|Ncms|potage
potinage|Ncms|potinage
poudrage|Ncms|poudrage
poudrement|Ncms|poudrement
poudroiement|Ncms|poudroiement
pouillotement|Ncms|pouillotement
poulage|Ncms|poulage
pouliage|Ncms|pouliage
poulinage|Ncms|poulinage
poulinement|Ncms|poulinement
pourcentage|Ncms|pourcentage
pourrissage|Ncms|pourrissage
pourrissement|Ncms|pourrissement
poussage|Ncms|poussage
poussement|Ncms|poussement
poutrage|Ncms|poutrage
préarrangement|Ncms|préarrangement
préchauffage|Ncms|préchauffage
précomptage|Ncms|précomptage
prédébourrement|Ncms|prédébourrement
prédicament|Ncms|prédicament
préembarquement|Ncms|préembarquement
préforage|Ncms|préforage
préimage|Ncfs|préimage
préjugement|Ncms|préjugement
prélavage|Ncms|prélavage
prélèvement|Ncms|prélèvement
pralinage|Ncms|pralinage
préparage|Ncms|préparage
prérinçage|Ncms|prérinçage
présage|Ncms|présage
prétrempage|Ncms|prétrempage
pressage|Ncms|pressage
pressentiment|Ncms|pressentiment
pressurage|Ncms|pressurage
pressurement|Ncms|pressurement
primage|Ncms|primage
profilage|Ncms|profilage
projettement|Ncms|projettement
prolongement|Ncms|prolongement
promènement|Ncms|promènement
prosternement|Ncms|prosternement
prototypage|Ncms|prototypage
provignage|Ncms|provignage
provignement|Ncms|provignement
psalmodiement|Ncms|psalmodiement
psychoverbiage|Ncms|psychoverbiage
publipostage|Ncms|publipostage
publireportage|Ncms|publireportage
pucelage|Ncms|pucelage
puddlage|Ncms|puddlage
puisage|Ncms|puisage
puisement|Ncms|puisement
pullulement|Ncms|pullulement
pulvérage|Ncms|pulvérage
purgement|Ncms|purgement
quadrillage|Ncms|quadrillage
quaiage|Ncms|quaiage
quayage|Ncms|quayage
quernage|Ncms|quernage
questionnement|Ncms|questionnement
queursage|Ncms|queursage
queutage|Ncms|queutage
quintelage|Ncms|quintelage
quintuplement|Ncms|quintuplement
quiossage|Ncms|quiossage
quottement|Ncms|quottement
réabonnement|Ncms|réabonnement
rééchantillonnage|Ncms|rééchantillonnage
rééchelonnement|Ncms|rééchelonnement
réacheminement|Ncms|réacheminement
réaffleurement|Ncms|réaffleurement
réagencement|Ncms|réagencement
réage|Ncms|réage
réajournement|Ncms|réajournement
réajustement|Ncms|réajustement
réalignement|Ncms|réalignement
réaménagement|Ncms|réaménagement
réapprovisionnement|Ncms|réapprovisionnement
rééquilibrage|Ncms|rééquilibrage
réarmement|Ncms|réarmement
réarrangement|Ncms|réarrangement
réarrimage|Ncms|réarrimage
réassortiment|Ncms|réassortiment
réattirement|Ncms|réattirement
rabâchage|Ncms|rabâchage
rabâchement|Ncms|rabâchement
rabaissement|Ncms|rabaissement
rabattage|Ncms|rabattage
rabattement|Ncms|rabattement
rabbinage|Ncms|rabbinage
rabibochage|Ncms|rabibochage
rabotage|Ncms|rabotage
rabotement|Ncms|rabotement
rabougrissement|Ncms|rabougrissement
raboutage|Ncms|raboutage
rabrouement|Ncms|rabrouement
rabutinage|Ncms|rabutinage
racage|Ncms|racage
racastillage|Ncms|racastillage
raccommodage|Ncms|raccommodage
raccommodement|Ncms|raccommodement
raccordement|Ncms|raccordement
raccourcissage|Ncms|raccourcissage
raccourcissement|Ncms|raccourcissement
raccrochage|Ncms|raccrochage
réchampissage|Ncms|réchampissage
réchauffage|Ncms|réchauffage
réchauffement|Ncms|réchauffement
rachevage|Ncms|rachevage
racinage|Ncms|racinage
râclage|Ncms|râclage
raclage|Ncms|raclage
raclement|Ncms|raclement
racolage|Ncms|racolage
récolement|Ncms|récolement
récompensement|Ncms|récompensement
racontage|Ncms|racontage
racornissement|Ncms|racornissement
récurage|Ncms|récurage
radioélément|Ncms|radioélément
radioalignement|Ncms|radioalignement
radiobalisage|Ncms|radiobalisage
radioguidage|Ncms|radioguidage
radioralliement|Ncms|radioralliement
radioreportage|Ncms|radioreportage
radiosondage|Ncms|radiosondage
radotage|Ncms|radotage
radotement|Ncms|radotement
radoucissement|Ncms|radoucissement
réemballage|Ncms|réemballage
réemménagement|Ncms|réemménagement
réempatage|Ncms|réempatage
réenclenchement|Ncms|réenclenchement
réengagement|Ncms|réengagement
réentement|Ncms|réentement
référencement|Ncms|référencement
raffermissement|Ncms|raffermissement
raffinage|Ncms|raffinage
raffinement|Ncms|raffinement
raffutage|Ncms|raffutage
rafistolage|Ncms|rafistolage
réfléchissement|Ncms|réfléchissement
raflage|Ncms|raflage
rafraîchissement|Ncms|rafraîchissement
rafraichissement|Ncms|rafraichissement
réfrènement|Ncms|réfrènement
ragage|Ncms|ragage
régalage|Ncms|régalage
raganage|Ncms|raganage
rage|Ncfs|rage
régimage|Ncms|régimage
régiment|Ncms|régiment
réglage|Ncms|réglage
réglement|Ncms|réglement
règlement|Ncms|règlement
ragoulement|Ncms|ragoulement
ragréage|Ncms|ragréage
ragrément|Ncms|ragrément
régulage|Ncms|régulage
raidissement|Ncms|raidissement
raiment|Ncms|raiment
rainage|Ncms|rainage
rainurage|Ncms|rainurage
raisonnement|Ncms|raisonnement
rajeunissement|Ncms|rajeunissement
rajustement|Ncms|rajustement
rôlage|Ncms|rôlage
rélargissement|Ncms|rélargissement
râlement|Ncms|râlement
ralentissement|Ncms|ralentissement
ralliement|Ncms|ralliement
rallongement|Ncms|rallongement
ramage|Ncms|ramage
ramaigrissement|Ncms|ramaigrissement
ramaillage|Ncms|ramaillage
ramassage|Ncms|ramassage
ramendage|Ncms|ramendage
rameutage|Ncms|rameutage
ramoitissement|Ncms|ramoitissement
ramollissement|Ncms|ramollissement
ramonage|Ncms|ramonage
rampement|Ncms|rampement
rançonnement|Ncms|rançonnement
rancissement|Ncms|rancissement
rangement|Ncms|rangement
réordonnancement|Ncms|réordonnancement
rapaisement|Ncms|rapaisement
répartement|Ncms|répartement
rapatriage|Ncms|rapatriage
rapatriement|Ncms|rapatriement
rapatronnage|Ncms|rapatronnage
répertoriage|Ncms|répertoriage
rapetissement|Ncms|rapetissement
rapiéçage|Ncms|rapiéçage
rapiècement|Ncms|rapiècement
rapiècetage|Ncms|rapiècetage
rappatriement|Ncms|rappatriement
rappointement|Ncms|rappointement
rapportage|Ncms|rapportage
rapprochement|Ncms|rapprochement
rapprovisionnement|Ncms|rapprovisionnement
répudiement|Ncms|répudiement
réquisitionnement|Ncms|réquisitionnement
rasage|Ncms|rasage
réseautage|Ncms|réseautage
rasement|Ncms|rasement
résinage|Ncms|résinage
rassasiement|Ncms|rassasiement
rassemblement|Ncms|rassemblement
rassissement|Ncms|rassissement
rassortiment|Ncms|rassortiment
rassotement|Ncms|rassotement
rassurement|Ncms|rassurement
rétablissement|Ncms|rétablissement
ratage|Ncms|ratage
rétamage|Ncms|rétamage
ratatinement|Ncms|ratatinement
râtelage|Ncms|râtelage
ratinage|Ncms|ratinage
rationnement|Ncms|rationnement
ratissage|Ncms|ratissage
rôtissage|Ncms|rôtissage
rétrécissement|Ncms|rétrécissement
rétroéclairage|Ncms|rétroéclairage
rétrogradage|Ncms|rétrogradage
rétropédalage|Ncms|rétropédalage
rétroportage|Ncms|rétroportage
rattachage|Ncms|rattachage
rattachement|Ncms|rattachement
rattrapage|Ncms|rattrapage
raturage|Ncms|raturage
rauchage|Ncms|rauchage
réunissage|Ncms|réunissage
rauquement|Ncms|rauquement
ravagement|Ncms|ravagement
ravage|Ncms|ravage
ravalement|Ncms|ravalement
ravaudage|Ncms|ravaudage
réveillement|Ncms|réveillement
ravilissement|Ncms|ravilissement
ravinement|Ncms|ravinement
ravisement|Ncms|ravisement
ravissement|Ncms|ravissement
ravitaillement|Ncms|ravitaillement
ravivage|Ncms|ravivage
ravivement|Ncms|ravivement
révoltement|Ncms|révoltement
rayage|Ncms|rayage
rayement|Ncms|rayement
rayonnage|Ncms|rayonnage
rayonnement|Ncms|rayonnement
rebasculement|Ncms|rebasculement
rebattement|Ncms|rebattement
rebillage|Ncms|rebillage
rebinage|Ncms|rebinage
reblocage|Ncms|reblocage
rebobinage|Ncms|rebobinage
reboisement|Ncms|reboisement
rebondissement|Ncms|rebondissement
rebouchage|Ncms|rebouchage
rebouclage|Ncms|rebouclage
rebouclement|Ncms|rebouclement
rebouisage|Ncms|rebouisage
reboutement|Ncms|reboutement
rebrasement|Ncms|rebrasement
rebuttage|Ncms|rebuttage
recadrage|Ncms|recadrage
recèlement|Ncms|recèlement
recamionnage|Ncms|recamionnage
recépage|Ncms|recépage
recarrelage|Ncms|recarrelage
recensement|Ncms|recensement
recentrage|Ncms|recentrage
recepage|Ncms|recepage
recepement|Ncms|recepement
recerclage|Ncms|recerclage
rechapage|Ncms|rechapage
rechargeage|Ncms|rechargeage
rechargement|Ncms|rechargement
rechaussage|Ncms|rechaussage
rechaussement|Ncms|rechaussement
rechignement|Ncms|rechignement
reclassement|Ncms|reclassement
recollage|Ncms|recollage
recollement|Ncms|recollement
recommencement|Ncms|recommencement
recomptage|Ncms|recomptage
reconditionnement|Ncms|reconditionnement
recoquage|Ncms|recoquage
recoquetage|Ncms|recoquetage
recoquillement|Ncms|recoquillement
recoulement|Ncms|recoulement
recoupement|Ncms|recoupement
recourbement|Ncms|recourbement
recousement|Ncms|recousement
recouvrage|Ncms|recouvrage
recouvrement|Ncms|recouvrement
recrépiment|Ncms|recrépiment
recrépissage|Ncms|recrépissage
recreusage|Ncms|recreusage
recreusement|Ncms|recreusement
recroisement|Ncms|recroisement
recroquevillement|Ncms|recroquevillement
recrutement|Ncms|recrutement
recueillement|Ncms|recueillement
recuisage|Ncms|recuisage
reculement|Ncms|reculement
recyclage|Ncms|recyclage
redécoupage|Ncms|redécoupage
redémarrage|Ncms|redémarrage
redéploiement|Ncms|redéploiement
redemandage|Ncms|redemandage
redentage|Ncms|redentage
redimensionnement|Ncms|redimensionnement
redoublement|Ncms|redoublement
redressage|Ncms|redressage
redressement|Ncms|redressement
refeuillement|Ncms|refeuillement
refinancement|Ncms|refinancement
refleurissement|Ncms|refleurissement
reforgement|Ncms|reforgement
reformage|Ncms|reformage
reformatage|Ncms|reformatage
refouillement|Ncms|refouillement
refoulage|Ncms|refoulage
refoulement|Ncms|refoulement
refrènement|Ncms|refrènement
refrappage|Ncms|refrappage
refrappement|Ncms|refrappement
refrognement|Ncms|refrognement
refroidissement|Ncms|refroidissement
regazonnement|Ncms|regazonnement
regimbement|Ncms|regimbement
regonflement|Ncms|regonflement
regorgement|Ncms|regorgement
regrêlage|Ncms|regrêlage
regrattage|Ncms|regrattage
regroupement|Ncms|regroupement
rehaussage|Ncms|rehaussage
rehaussement|Ncms|rehaussement
rejaillissement|Ncms|rejaillissement
rejettement|Ncms|rejettement
rejointoyement|Ncms|rejointoyement
relabourement|Ncms|relabourement
relâchement|Ncms|relâchement
relancement|Ncms|relancement
relargage|Ncms|relargage
relèvement|Ncms|relèvement
relevage|Ncms|relevage
relimage|Ncms|relimage
relogement|Ncms|relogement
relookage|Ncms|relookage
reloquetage|Ncms|reloquetage
relouage|Ncms|relouage
reméandrage|Ncms|reméandrage
reméchage|Ncms|reméchage
remâchement|Ncms|remâchement
remédiement|Ncms|remédiement
remaillage|Ncms|remaillage
remandrinage|Ncms|remandrinage
remaniement|Ncms|remaniement
remardage|Ncms|remardage
remariage|Ncms|remariage
remballage|Ncms|remballage
rembarquement|Ncms|rembarquement
remblaiement|Ncms|remblaiement
remblayage|Ncms|remblayage
remboîtage|Ncms|remboîtage
remboîtement|Ncms|remboîtement
rembobinage|Ncms|rembobinage
remboitage|Ncms|remboitage
remboitement|Ncms|remboitement
rembourrage|Ncms|rembourrage
rembourrement|Ncms|rembourrement
remboursement|Ncms|remboursement
rembrunissement|Ncms|rembrunissement
rembuchement|Ncms|rembuchement
remembrement|Ncms|remembrement
remercîment|Ncms|remercîment
remerciement|Ncms|remerciement
remettage|Ncms|remettage
remisage|Ncms|remisage
remmaillage|Ncms|remmaillage
remodelage|Ncms|remodelage
remondage|Ncms|remondage
remontage|Ncms|remontage
remorquage|Ncms|remorquage
remoulage|Ncms|remoulage
rempaillage|Ncms|rempaillage
rempaquement|Ncms|rempaquement
remplacement|Ncms|remplacement
remplage|Ncms|remplage
remplissage|Ncms|remplissage
rempoissonnement|Ncms|rempoissonnement
rempotage|Ncms|rempotage
remuage|Ncms|remuage
remuement|Ncms|remuement
renâclement|Ncms|renâclement
rencaissage|Ncms|rencaissage
rencaissement|Ncms|rencaissement
renchérissement|Ncms|renchérissement
rencoquillage|Ncms|rencoquillage
rendement|Ncms|rendement
rendurcissement|Ncms|rendurcissement
renfaîtage|Ncms|renfaîtage
renfaitage|Ncms|renfaitage
renfermement|Ncms|renfermement
renflement|Ncms|renflement
renflouage|Ncms|renflouage
renflouement|Ncms|renflouement
renfoncement|Ncms|renfoncement
renforcement|Ncms|renforcement
renfrognement|Ncms|renfrognement
rengagement|Ncms|rengagement
rengorgement|Ncms|rengorgement
rengrènement|Ncms|rengrènement
rengrénement|Ncms|rengrénement
reniement|Ncms|reniement
reniflement|Ncms|reniflement
renivellement|Ncms|renivellement
renommage|Ncms|renommage
renoncement|Ncms|renoncement
renouement|Ncms|renouement
renouvèlement|Ncms|renouvèlement
renouvellement|Ncms|renouvellement
renseignement|Ncms|renseignement
rentoilage|Ncms|rentoilage
rentrayage|Ncms|rentrayage
renversement|Ncms|renversement
renvidage|Ncms|renvidage
repêchage|Ncms|repêchage
repaquage|Ncms|repaquage
repérage|Ncms|repérage
repartonnage|Ncms|repartonnage
repassage|Ncms|repassage
repatriement|Ncms|repatriement
repavage|Ncms|repavage
repavement|Ncms|repavement
repeuplement|Ncms|repeuplement
repiquage|Ncms|repiquage
repiquement|Ncms|repiquement
replacement|Ncms|replacement
replantement|Ncms|replantement
replâtrage|Ncms|replâtrage
repliement|Ncms|repliement
reploiement|Ncms|reploiement
repolissage|Ncms|repolissage
repompage|Ncms|repompage
reportage|Ncms|reportage
repoussement|Ncms|repoussement
repoustage|Ncms|repoustage
reprisage|Ncms|reprisage
requêtage|Ncms|requêtage
reroutage|Ncms|reroutage
reséquençage|Ncms|reséquençage
resarcissage|Ncms|resarcissage
rescellement|Ncms|rescellement
resplendissement|Ncms|resplendissement
resquillage|Ncms|resquillage
ressaisissement|Ncms|ressaisissement
ressassage|Ncms|ressassage
ressassement|Ncms|ressassement
ressemelage|Ncms|ressemelage
ressentiment|Ncms|ressentiment
resserrement|Ncms|resserrement
ressuage|Ncms|ressuage
ressuscitement|Ncms|ressuscitement
ressuyage|Ncms|ressuyage
restoupage|Ncms|restoupage
resurfaçage|Ncms|resurfaçage
retaillement|Ncms|retaillement
retannage|Ncms|retannage
retardement|Ncms|retardement
retentissement|Ncms|retentissement
reterçage|Ncms|reterçage
retirage|Ncms|retirage
retirement|Ncms|retirement
retordage|Ncms|retordage
retordement|Ncms|retordement
retouchage|Ncms|retouchage
retournement|Ncms|retournement
retraitement|Ncms|retraitement
retranchement|Ncms|retranchement
retroussage|Ncms|retroussage
retroussement|Ncms|retroussement
retubage|Ncms|retubage
revêtement|Ncms|revêtement
revêtissement|Ncms|revêtissement
reverdissement|Ncms|reverdissement
revidage|Ncms|revidage
revirement|Ncms|revirement
revomissement|Ncms|revomissement
rhabillage|Ncms|rhabillage
rhabillement|Ncms|rhabillement
rhapsodage|Ncms|rhapsodage
riblage|Ncms|riblage
ribordage|Ncms|ribordage
ribotypage|Ncms|ribotypage
ricanement|Ncms|ricanement
ridage|Ncms|ridage
ridement|Ncms|ridement
rigolage|Ncms|rigolage
rinçage|Ncms|rinçage
rincement|Ncms|rincement
ripage|Ncms|ripage
ripolinage|Ncms|ripolinage
rittage|Ncms|rittage
rivage|Ncms|rivage
rivement|Ncms|rivement
rivetage|Ncms|rivetage
robage|Ncms|robage
robelage|Ncms|robelage
rocaillage|Ncms|rocaillage
rochage|Ncms|rochage
rodage|Ncms|rodage
rognage|Ncms|rognage
roidissement|Ncms|roidissement
rompement|Ncms|rompement
ronéotage|Ncms|ronéotage
ronchonnement|Ncms|ronchonnement
ronflement|Ncms|ronflement
rongement|Ncms|rongement
ronronnement|Ncms|ronronnement
rosissement|Ncms|rosissement
rossignolement|Ncms|rossignolement
rostage|Ncms|rostage
rotoquage|Ncms|rotoquage
rouage|Ncms|rouage
roucoulement|Ncms|roucoulement
rougeoiement|Ncms|rougeoiement
rougissement|Ncms|rougissement
rouissage|Ncms|rouissage
roulage|Ncms|roulage
roulement|Ncms|roulement
roulottage|Ncms|roulottage
roussissage|Ncms|roussissage
roussissement|Ncms|roussissement
routage|Ncms|routage
rubanement|Ncfs|rubanement
rudiment|Ncms|rudiment
rudoyement|Ncms|rudoyement
ruement|Ncms|ruement
rugissement|Ncms|rugissement
ruinement|Ncms|ruinement
ruissèlement|Ncms|ruissèlement
ruissellement|Ncms|ruissellement
rusticage|Ncms|rusticage
sablage|Ncms|sablage
sabordage|Ncms|sabordage
sabordement|Ncms|sabordement
sabotage|Ncms|sabotage
saboulage|Ncms|saboulage
sabrage|Ncms|sabrage
saccagement|Ncms|saccagement
saccage|Ncms|saccage
séchage|Ncms|séchage
sacrement|Ncms|sacrement
sédiment|Ncms|sédiment
sage|Ncfs|sage
sage|Ncms|sage
saignement|Ncms|saignement
saisissement|Ncms|saisissement
séjournement|Ncms|séjournement
salage|Ncms|salage
salinage|Ncms|salinage
salissage|Ncms|salissage
salissement|Ncms|salissement
salopage|Ncms|salopage
salpêtrage|Ncms|salpêtrage
sanctionnement|Ncms|sanctionnement
sanglotement|Ncms|sanglotement
séparage|Ncms|séparage
séparement|Ncms|séparement
sapement|Ncms|sapement
sapinage|Ncms|sapinage
séquençage|Ncms|séquençage
sérançage|Ncms|sérançage
sérénage|Ncms|sérénage
sarclage|Ncms|sarclage
sarcophage|Ncfs|sarcophage
sarcophage|Ncms|sarcophage
sarment|Ncms|sarment
sérogroupage|Ncms|sérogroupage
sérotriage|Ncms|sérotriage
sérotypage|Ncms|sérotypage
sartage|Ncms|sartage
sassement|Ncms|sassement
sassenage|Ncms|sassenage
satinage|Ncms|satinage
sétophage|Ncfs|sétophage
saucissonnage|Ncms|saucissonnage
saumurage|Ncms|saumurage
saunage|Ncms|saunage
saupoudrage|Ncms|saupoudrage
saurage|Ncms|saurage
saurissage|Ncms|saurissage
sautage|Ncms|sautage
sautillage|Ncms|sautillage
sautillement|Ncms|sautillement
sauvage|Ncms|sauvage
sauvetage|Ncms|sauvetage
savonnage|Ncms|savonnage
savourement|Ncms|savourement
saxifrage|Ncfs|saxifrage
saxifrage|Ncms|saxifrage
scalpage|Ncms|scalpage
scalpement|Ncms|scalpement
scénarimage|Ncms|scénarimage
scannage|Ncms|scannage
scarifiage|Ncms|scarifiage
scellage|Ncms|scellage
scellement|Ncms|scellement
schappage|Ncms|schappage
schlittage|Ncms|schlittage
schlotage|Ncms|schlotage
sciage|Ncms|sciage
scintillement|Ncms|scintillement
sclaunage|Ncms|sclaunage
scriblage|Ncms|scriblage
secouage|Ncms|secouage
secouement|Ncms|secouement
secrétage|Ncms|secrétage
sectionnement|Ncms|sectionnement
segment|Ncms|segment
seigneuriage|Ncms|seigneuriage
sellage|Ncms|sellage
semelage|Ncms|semelage
sentiment|Ncms|sentiment
serfouissage|Ncms|serfouissage
serinage|Ncms|serinage
seringage|Ncms|seringage
seringuement|Ncms|seringuement
serment|Ncms|serment
serpentage|Ncms|serpentage
serpentement|Ncms|serpentement
serrage|Ncms|serrage
serrement|Ncms|serrement
sertissage|Ncms|sertissage
servage|Ncms|servage
sesseyement|Ncms|sesseyement
seterage|Ncms|seterage
seuillage|Ncms|seuillage
sevrage|Ncms|sevrage
sexage|Ncms|sexage
sibilement|Ncms|sibilement
sifflage|Ncms|sifflage
sifflement|Ncms|sifflement
sifflotement|Ncms|sifflotement
signage|Ncms|signage
signalement|Ncms|signalement
sillage|Ncms|sillage
silotage|Ncms|silotage
similisage|Ncms|similisage
sinçage|Ncms|sinçage
siphonage|Ncms|siphonage
sippage|Ncms|sippage
smillage|Ncms|smillage
socage|Ncms|socage
socquement|Ncms|socquement
soignage|Ncms|soignage
solidage|Ncfs|solidage
solutionnage|Ncms|solutionnage
sombrage|Ncms|sombrage
sommeillement|Ncms|sommeillement
sondage|Ncms|sondage
soubassement|Ncms|soubassement
souchetage|Ncms|souchetage
souchevage|Ncms|souchevage
soudage|Ncms|soudage
soufflage|Ncms|soufflage
soufflement|Ncms|soufflement
soufrage|Ncms|soufrage
souillement|Ncms|souillement
soulagement|Ncms|soulagement
soulèvement|Ncms|soulèvement
soulignage|Ncms|soulignage
soulignement|Ncms|soulignement
soupèsement|Ncms|soupèsement
soupirement|Ncms|soupirement
sourçage|Ncms|sourçage
soutènement|Ncms|soutènement
soutirage|Ncms|soutirage
spoulage|Ncms|spoulage
stage|Ncms|stage
stannage|Ncms|stannage
sténosage|Ncms|sténosage
stérage|Ncms|stérage
stéréotypage|Ncms|stéréotypage
stationnement|Ncms|stationnement
stellage|Ncms|stellage
steppage|Ncms|steppage
sternopage|Ncms|sternopage
sthénosage|Ncms|sthénosage
stickage|Ncms|stickage
stockage|Ncms|stockage
stoppage|Ncms|stoppage
striage|Ncms|striage
stricage|Ncms|stricage
stucage|Ncms|stucage
suage|Ncms|suage
submergement|Ncms|submergement
subornement|Ncms|subornement
subventionnement|Ncms|subventionnement
sucement|Ncms|sucement
sucrage|Ncms|sucrage
suffrage|Ncms|suffrage
suintement|Ncms|suintement
suivage|Ncms|suivage
sulfatage|Ncms|sulfatage
sulfitage|Ncms|sulfitage
sulfocarbonatage|Ncms|sulfocarbonatage
sulfurage|Ncms|sulfurage
superdécrochage|Ncms|superdécrochage
superembranchement|Ncms|superembranchement
supplément|Ncms|supplément
supplantement|Ncms|supplantement
supportage|Ncms|supportage
suraffinage|Ncms|suraffinage
surégalisage|Ncms|surégalisage
surapprentissage|Ncms|surapprentissage
suréquipement|Ncms|suréquipement
surarmement|Ncms|surarmement
surbaissement|Ncms|surbaissement
surblindage|Ncms|surblindage
surbouchage|Ncms|surbouchage
surcadençage|Ncms|surcadençage
surcadencement|Ncms|surcadencement
surclassement|Ncms|surclassement
surcreusement|Ncms|surcreusement
surdosage|Ncms|surdosage
suremballage|Ncms|suremballage
surencadrement|Ncms|surencadrement
surenchérissement|Ncms|surenchérissement
surencombrement|Ncms|surencombrement
surendettement|Ncms|surendettement
surentraînement|Ncms|surentraînement
surentrainement|Ncms|surentrainement
surfaçage|Ncms|surfaçage
surfilage|Ncms|surfilage
surfréquençage|Ncms|surfréquençage
surgissement|Ncms|surgissement
surhaussement|Ncms|surhaussement
surinvestissement|Ncms|surinvestissement
surlignage|Ncms|surlignage
surmenage|Ncms|surmenage
surmoulage|Ncms|surmoulage
surpassement|Ncms|surpassement
surpâturage|Ncms|surpâturage
surpeuplement|Ncms|surpeuplement
surplombement|Ncms|surplombement
survêtement|Ncms|survêtement
surversement|Ncms|surversement
survirage|Ncms|survirage
survoltage|Ncms|survoltage
susseyement|Ncms|susseyement
susurrement|Ncms|susurrement
tabarinage|Ncms|tabarinage
tabassage|Ncms|tabassage
taconnage|Ncms|taconnage
taggage|Ncms|taggage
tégument|Ncms|tégument
tailladage|Ncms|tailladage
taillage|Ncms|taillage
téléchargement|Ncms|téléchargement
télédémarchage|Ncms|télédémarchage
téléenseignement|Ncms|téléenseignement
tôlage|Ncms|tôlage
téléguidage|Ncms|téléguidage
téléjalonnement|Ncms|téléjalonnement
télépéage|Ncms|télépéage
télépaiement|Ncms|télépaiement
téléphérage|Ncms|téléphérage
téléphonage|Ncms|téléphonage
télépointage|Ncms|télépointage
téléréglage|Ncms|téléréglage
téléreportage|Ncms|téléreportage
télétraitement|Ncms|télétraitement
téléversement|Ncms|téléversement
télescopage|Ncms|télescopage
tallage|Ncms|tallage
talonnage|Ncms|talonnage
talonnement|Ncms|talonnement
talutage|Ncms|talutage
tambourinage|Ncms|tambourinage
tambourinement|Ncms|tambourinement
tamisage|Ncms|tamisage
témoignage|Ncms|témoignage
tampage|Ncms|tampage
tamponnage|Ncms|tamponnage
tamponnement|Ncms|tamponnement
tancement|Ncms|tancement
ténement|Ncms|ténement
tènement|Ncms|tènement
tangage|Ncms|tangage
tanisage|Ncms|tanisage
tannage|Ncms|tannage
tannisage|Ncms|tannisage
tapage|Ncms|tapage
tapement|Ncms|tapement
tapinage|Ncms|tapinage
tapirage|Ncms|tapirage
tapissage|Ncfs|tapissage
taponnage|Ncms|taponnage
tapotage|Ncms|tapotage
tapotement|Ncms|tapotement
taquage|Ncms|taquage
taquinage|Ncms|taquinage
tarabiscotage|Ncms|tarabiscotage
tarage|Ncms|tarage
taraudage|Ncms|taraudage
tarissement|Ncms|tarissement
tarmacadamisage|Ncms|tarmacadamisage
tarponnage|Ncms|tarponnage
tartouillage|Ncms|tartouillage
tassage|Ncms|tassage
tassement|Ncms|tassement
tâtage|Ncms|tâtage
tétage|Ncms|tétage
tataouinage|Ncms|tataouinage
tatillonnage|Ncms|tatillonnage
tâtonnement|Ncms|tâtonnement
tatouage|Ncms|tatouage
tatouement|Ncms|tatouement
tavelage|Ncms|tavelage
tavellage|Ncms|tavellage
tavillonnage|Ncms|tavillonnage
taxage|Ncms|taxage
teillage|Ncms|teillage
tempêtement|Ncms|tempêtement
tempérage|Ncms|tempérage
tempérament|Ncms|tempérament
tenaillement|Ncms|tenaillement
tentement|Ncms|tentement
termaillage|Ncms|termaillage
ternage|Ncms|ternage
ternissement|Ncms|ternissement
terraformage|Ncms|terraformage
terrage|Ncms|terrage
terrassement|Ncms|terrassement
terreautage|Ncms|terreautage
terrement|Ncms|terrement
testage|Ncms|testage
Testament|Ncms|Testament
testament|Ncms|testament
thémage|Ncms|thémage
tiaulement|Ncms|tiaulement
tierçage|Ncms|tierçage
tillage|Ncms|tillage
timbrage|Ncms|timbrage
tinage|Ncms|tinage
tintement|Ncms|tintement
tintinnabulement|Ncms|tintinnabulement
tirage|Ncms|tirage
tiraillement|Ncms|tiraillement
tirebouchonnement|Ncms|tirebouchonnement
tirement|Ncms|tirement
tirlipotage|Ncms|tirlipotage
tisage|Ncms|tisage
tissage|Ncms|tissage
titillement|Ncms|titillement
titinement|Ncms|titinement
titrage|Ncms|titrage
titrement|Ncms|titrement
tocage|Ncms|tocage
toilage|Ncms|toilage
toilettage|Ncms|toilettage
tondage|Ncms|tondage
tonitrument|Ncms|tonitrument
tonnage|Ncms|tonnage
tonnelage|Ncms|tonnelage
toquage|Ncms|toquage
torchage|Ncms|torchage
tordage|Ncms|tordage
torpillage|Ncms|torpillage
tortillage|Ncms|tortillage
tortillement|Ncms|tortillement
touage|Ncms|touage
touffetage|Ncms|touffetage
touillage|Ncms|touillage
toupillage|Ncms|toupillage
touraillage|Ncms|touraillage
tourbage|Ncms|tourbage
tourbillonnement|Ncms|tourbillonnement
tourment|Ncms|tourment
tournage|Ncms|tournage
tournasage|Ncms|tournasage
tournassage|Ncms|tournassage
tournoiement|Ncms|tournoiement
toussotement|Ncms|toussotement
traçage|Ncms|traçage
traînage|Ncms|traînage
traînassement|Ncms|traînassement
traînement|Ncms|traînement
trébuchage|Ncms|trébuchage
trébuchement|Ncms|trébuchement
tracanage|Ncms|tracanage
tracement|Ncms|tracement
tractage|Ncms|tractage
tréfilage|Ncms|tréfilage
trainage|Ncms|trainage
trainement|Ncms|trainement
traitement|Ncms|traitement
tréjetage|Ncms|tréjetage
trélingage|Ncms|trélingage
tramage|Ncms|tramage
trématage|Ncms|trématage
trémoussement|Ncms|trémoussement
tranchage|Ncms|tranchage
tranchement|Ncms|tranchement
transbordement|Ncms|transbordement
transcodage|Ncms|transcodage
transfèrement|Ncms|transfèrement
transfilage|Ncms|transfilage
transplantement|Ncms|transplantement
transtypage|Ncms|transtypage
transvasement|Ncms|transvasement
trépignement|Ncms|trépignement
trappage|Ncms|trappage
trétinage|Ncms|trétinage
travaillement|Ncms|travaillement
travelage|Ncms|travelage
travellage|Ncms|travellage
traversement|Ncms|traversement
travestissement|Ncms|travestissement
treillage|Ncms|treillage
tremblement|Ncms|tremblement
tremblotement|Ncms|tremblotement
trempage|Ncms|trempage
tressage|Ncms|tressage
tressaillement|Ncms|tressaillement
tressautement|Ncms|tressautement
treuillage|Ncms|treuillage
triage|Ncms|triage
tricotage|Ncms|tricotage
trimbalage|Ncms|trimbalage
tripatouillage|Ncms|tripatouillage
triplement|Ncms|triplement
tripotage|Ncms|tripotage
trollage|Ncms|trollage
trompement|Ncms|trompement
tronçonnage|Ncms|tronçonnage
tronquement|Ncms|tronquement
troussage|Ncms|troussage
truandage|Ncms|truandage
trucage|Ncms|trucage
truchement|Ncms|truchement
truquage|Ncms|truquage
tuage|Ncms|tuage
tubage|Ncms|tubage
tuilage|Ncms|tuilage
tunage|Ncms|tunage
turbinage|Ncms|turbinage
turlupinage|Ncms|turlupinage
tussilage|Ncms|tussilage
tuteurage|Ncms|tuteurage
tutoiement|Ncms|tutoiement
tutoiment|Ncms|tutoiment
tuyautage|Ncms|tuyautage
typage|Ncms|typage
ululement|Ncms|ululement
usage|Ncms|usage
usement|Ncms|usement
usinage|Ncms|usinage
uvage|Ncms|uvage
vêlage|Ncms|vêlage
vêlement|Ncms|vêlement
vêtage|Ncms|vêtage
vêtement|Ncms|vêtement
vagabondage|Ncms|vagabondage
vagissement|Ncms|vagissement
vaguage|Ncms|vaguage
véhiculage|Ncms|véhiculage
vaigrage|Ncms|vaigrage
vallonnement|Ncms|vallonnement
vannage|Ncms|vannage
vapocraquage|Ncms|vapocraquage
vaporisage|Ncms|vaporisage
vasselage|Ncms|vasselage
vautrement|Ncms|vautrement
veillement|Ncms|veillement
vendage|Ncms|vendage
ventage|Ncms|ventage
ventousage|Ncms|ventousage
verbiage|Ncms|verbiage
verdage|Ncms|verdage
verdissage|Ncms|verdissage
verdissement|Ncms|verdissement
verjage|Ncms|verjage
vermiculage|Ncms|vermiculage
vermillonnage|Ncms|vermillonnage
vernissage|Ncms|vernissage
verrouillage|Ncms|verrouillage
versage|Ncms|versage
versement|Ncms|versement
versionnage|Ncms|versionnage
veuvage|Ncms|veuvage
vibrage|Ncms|vibrage
vidage|Ncms|vidage
vidéolynchage|Ncms|vidéolynchage
vieillissement|Ncms|vieillissement
vignetage|Ncms|vignetage
vignettage|Ncms|vignettage
vignolage|Ncms|vignolage
vilainage|Ncms|vilainage
vilipendement|Ncms|vilipendement
village|Ncms|village
vinage|Ncms|vinage
virage|Ncms|virage
virement|Ncms|virement
virolage|Ncms|virolage
virophage|Ncms|virophage
visage|Ncms|visage
visionnage|Ncms|visionnage
visionnement|Ncms|visionnement
visnage|Ncms|visnage
vissage|Ncms|vissage
vitrage|Ncms|vitrage
vitriolage|Ncms|vitriolage
voilage|Ncms|voilage
voilement|Ncms|voilement
voisement|Ncms|voisement
voisinage|Ncms|voisinage
voiturage|Ncms|voiturage
volage|Ncfs|volage
volage|Ncms|volage
volètement|Ncms|volètement
volement|Ncms|volement
volettement|Ncms|volettement
voligeage|Ncms|voligeage
voltage|Ncms|voltage
voltigement|Ncms|voltigement
vomissage|Ncms|vomissage
vomissement|Ncms|vomissement
vouvoiement|Ncms|vouvoiement
voyage|Ncms|voyage
vrillage|Ncms|vrillage
vrillement|Ncms|vrillement
vrombissement|Ncms|vrombissement
wagage|Ncms|wagage
wagonnage|Ncms|wagonnage
warrantage|Ncms|warrantage
whitelistage|Ncms|whitelistage
xérophage|Ncms|xérophage
xylophage|Ncms|xylophage
zappage|Ncms|zappage
zérotage|Ncms|zérotage
zézaiement|Ncms|zézaiement
zigonnage|Ncms|zigonnage
zincage|Ncms|zincage
zingage|Ncms|zingage
zinzinulement|Ncms|zinzinulement
zonage|Ncms|zonage
zonzonnement|Ncms|zonzonnement
zozotement|Ncms|zozotement
